PokerStars Zoom Hand #188747578654:  Hold'em No Limit ($0.05/$0.10) - 2018/07/15 13:05:36 WET [2018/07/15 8:05:36 ET]
Table 'Aludra' 6-max Seat #1 is the button
Seat 1: CojocaruSV ($9.40 in chips) 
Seat 2: 1_gaborik ($10.28 in chips) 
Seat 3: WI7ZZ ($10 in chips) 
Seat 4: Sea Bas123 ($7.40 in chips) 
Seat 5: GeorgtheLord ($11.92 in chips) 
Seat 6: jump9922 ($17.60 in chips) 
1_gaborik: posts small blind $0.05
WI7ZZ: posts big blind $0.10
*** HOLE CARDS ***
Dealt to WI7ZZ [9s Ks]
Sea Bas123: folds 
GeorgtheLord: folds 
jump9922: raises $0.15 to $0.25
CojocaruSV: folds 
1_gaborik: folds 
WI7ZZ: calls $0.15
*** FLOP *** [9d Td As]
WI7ZZ: checks 
jump9922: bets $0.40
WI7ZZ: calls $0.40
*** TURN *** [9d Td As] [9c]
WI7ZZ: checks 
jump9922: bets $0.86
WI7ZZ: raises $1.87 to $2.73
jump9922: calls $1.87
*** RIVER *** [9d Td As 9c] [Kc]
WI7ZZ: bets $2.86
jump9922: calls $2.86
*** SHOW DOWN ***
WI7ZZ: shows [9s Ks] (a full house, Nines full of Kings)
jump9922: mucks hand 
WI7ZZ collected $11.97 from pot
*** SUMMARY ***
Total pot $12.53 | Rake $0.56 
Board [9d Td As 9c Kc]
Seat 1: CojocaruSV (button) folded before Flop (didn't bet)
Seat 2: 1_gaborik (small blind) folded before Flop
Seat 3: WI7ZZ (big blind) showed [9s Ks] and won ($11.97) with a full house, Nines full of Kings
Seat 4: Sea Bas123 folded before Flop (didn't bet)
Seat 5: GeorgtheLord folded before Flop (didn't bet)
Seat 6: jump9922 mucked [Kd Ad]



PokerStars Zoom Hand #188747621176:  Hold'em No Limit ($0.05/$0.10) - 2018/07/15 13:07:11 WET [2018/07/15 8:07:11 ET]
Table 'Aludra' 6-max Seat #1 is the button
Seat 1: unreal121 ($12.15 in chips) 
Seat 2: WI7ZZ ($15.73 in chips) 
Seat 3: mir0417 ($14.38 in chips) 
Seat 4: guluguluha ($10.58 in chips) 
Seat 5: Gissbon ($10.15 in chips) 
Seat 6: VAHRAMASHEN ($10 in chips) 
WI7ZZ: posts small blind $0.05
mir0417: posts big blind $0.10
*** HOLE CARDS ***
Dealt to WI7ZZ [5h Qc]
guluguluha: folds 
Gissbon: raises $0.15 to $0.25
VAHRAMASHEN: raises $0.55 to $0.80
unreal121: folds 
WI7ZZ: folds 
mir0417: folds 
Gissbon: folds 
Uncalled bet ($0.55) returned to VAHRAMASHEN
VAHRAMASHEN collected $0.65 from pot
VAHRAMASHEN: doesn't show hand 
*** SUMMARY ***
Total pot $0.65 | Rake $0 
Seat 1: unreal121 (button) folded before Flop (didn't bet)
Seat 2: WI7ZZ (small blind) folded before Flop
Seat 3: mir0417 (big blind) folded before Flop
Seat 4: guluguluha folded before Flop (didn't bet)
Seat 5: Gissbon folded before Flop
Seat 6: VAHRAMASHEN collected ($0.65)



PokerStars Zoom Hand #188747626552:  Hold'em No Limit ($0.05/$0.10) - 2018/07/15 13:07:23 WET [2018/07/15 8:07:23 ET]
Table 'Aludra' 6-max Seat #1 is the button
Seat 1: WI7ZZ ($15.68 in chips) 
Seat 2: sanich80 ($8.43 in chips) 
Seat 3: Drake-Thai ($17.60 in chips) 
Seat 4: kazyunok ($10.50 in chips) 
Seat 5: beta_hous3 ($10 in chips) 
Seat 6: bubica0 ($9.18 in chips) 
sanich80: posts small blind $0.05
Drake-Thai: posts big blind $0.10
*** HOLE CARDS ***
Dealt to WI7ZZ [7d 6d]
kazyunok: folds 
beta_hous3: folds 
bubica0: raises $0.15 to $0.25
WI7ZZ: folds 
sanich80: calls $0.20
Drake-Thai: folds 
*** FLOP *** [8h 4d 7s]
sanich80: checks 
bubica0: bets $0.38
sanich80: calls $0.38
*** TURN *** [8h 4d 7s] [3h]
sanich80: bets $0.60
bubica0: calls $0.60
*** RIVER *** [8h 4d 7s 3h] [Ad]
sanich80: bets $1.20
bubica0: calls $1.20
*** SHOW DOWN ***
sanich80: shows [Ah Qh] (a pair of Aces)
bubica0: mucks hand 
sanich80 collected $4.74 from pot
*** SUMMARY ***
Total pot $4.96 | Rake $0.22 
Board [8h 4d 7s 3h Ad]
Seat 1: WI7ZZ (button) folded before Flop (didn't bet)
Seat 2: sanich80 (small blind) showed [Ah Qh] and won ($4.74) with a pair of Aces
Seat 3: Drake-Thai (big blind) folded before Flop
Seat 4: kazyunok folded before Flop (didn't bet)
Seat 5: beta_hous3 folded before Flop (didn't bet)
Seat 6: bubica0 mucked [5c 8c]


PokerStars Zoom Hand #188747641422:  Hold'em No Limit ($0.05/$0.10) - 2018/07/15 13:07:56 WET [2018/07/15 8:07:56 ET]
Table 'Aludra' 6-max Seat #1 is the button
Seat 1: Day Day Up6 ($12.63 in chips) 
Seat 2: Foosball1980 ($10.15 in chips) 
Seat 3: -=l Grek l=- ($19.77 in chips) 
Seat 4: Ed_banany ($13.44 in chips) 
Seat 5: WI7ZZ ($15.68 in chips) 
Seat 6: Spooks1337 ($13.75 in chips) 
Foosball1980: posts small blind $0.05
-=l Grek l=-: posts big blind $0.10
*** HOLE CARDS ***
Dealt to WI7ZZ [6d 7d]
Ed_banany: folds 
WI7ZZ: folds 
Spooks1337: folds 
Day Day Up6: raises $0.15 to $0.25
Foosball1980: folds 
-=l Grek l=-: raises $0.55 to $0.80
Day Day Up6: folds 
Uncalled bet ($0.55) returned to -=l Grek l=-
-=l Grek l=- collected $0.55 from pot
-=l Grek l=-: doesn't show hand 
*** SUMMARY ***
Total pot $0.55 | Rake $0 
Seat 1: Day Day Up6 (button) folded before Flop
Seat 2: Foosball1980 (small blind) folded before Flop
Seat 3: -=l Grek l=- (big blind) collected ($0.55)
Seat 4: Ed_banany folded before Flop (didn't bet)
Seat 5: WI7ZZ folded before Flop (didn't bet)
Seat 6: Spooks1337 folded before Flop (didn't bet)



PokerStars Zoom Hand #188747643254:  Hold'em No Limit ($0.05/$0.10) - 2018/07/15 13:08:00 WET [2018/07/15 8:08:00 ET]
Table 'Aludra' 6-max Seat #1 is the button
Seat 1: PleyaDeanS ($21.97 in chips) 
Seat 2: Ed_banany ($13.44 in chips) 
Seat 3: GrinPisik ($4.10 in chips) 
Seat 4: WI7ZZ ($15.68 in chips) 
Seat 5: Day Day Up6 ($11.76 in chips) 
Seat 6: Andra.Andu ($11.39 in chips) 
Ed_banany: posts small blind $0.05
GrinPisik: posts big blind $0.10
*** HOLE CARDS ***
Dealt to WI7ZZ [Ac Th]
WI7ZZ: raises $0.26 to $0.36
Day Day Up6: folds 
Andra.Andu: folds 
PleyaDeanS: folds 
Ed_banany: folds 
GrinPisik: calls $0.26
*** FLOP *** [3s 6d 4d]
GrinPisik: checks 
WI7ZZ: bets $0.28
GrinPisik: calls $0.28
*** TURN *** [3s 6d 4d] [7d]
GrinPisik: checks 
WI7ZZ: bets $0.56
GrinPisik: calls $0.56
*** RIVER *** [3s 6d 4d 7d] [2h]
GrinPisik: checks 
WI7ZZ: checks 
*** SHOW DOWN ***
GrinPisik: shows [9c 8s] (high card Nine)
WI7ZZ: shows [Ac Th] (high card Ace)
WI7ZZ collected $2.34 from pot
*** SUMMARY ***
Total pot $2.45 | Rake $0.11 
Board [3s 6d 4d 7d 2h]
Seat 1: PleyaDeanS (button) folded before Flop (didn't bet)
Seat 2: Ed_banany (small blind) folded before Flop
Seat 3: GrinPisik (big blind) showed [9c 8s] and lost with high card Nine
Seat 4: WI7ZZ showed [Ac Th] and won ($2.34) with high card Ace
Seat 5: Day Day Up6 folded before Flop (didn't bet)
Seat 6: Andra.Andu folded before Flop (didn't bet)



PokerStars Zoom Hand #188747635539:  Hold'em No Limit ($0.05/$0.10) - 2018/07/15 13:07:43 WET [2018/07/15 8:07:43 ET]
Table 'Aludra' 6-max Seat #1 is the button
Seat 1: 19marc70 ($11.16 in chips) 
Seat 2: ysha76 ($21.96 in chips) 
Seat 3: jinn171700 ($9.14 in chips) 
Seat 4: Andra.Andu ($10.91 in chips) 
Seat 5: Heian Tachi ($5.73 in chips) 
Seat 6: WI7ZZ ($15.68 in chips) 
ysha76: posts small blind $0.05
jinn171700: posts big blind $0.10
*** HOLE CARDS ***
Dealt to WI7ZZ [Tc 9d]
Andra.Andu: folds 
Heian Tachi: folds 
WI7ZZ: folds 
19marc70: raises $0.20 to $0.30
ysha76: calls $0.25
jinn171700: folds 
*** FLOP *** [2d 5c 7d]
ysha76: checks 
19marc70: bets $0.34
ysha76: calls $0.34
*** TURN *** [2d 5c 7d] [Td]
ysha76: checks 
19marc70: bets $0.66
ysha76: folds 
Uncalled bet ($0.66) returned to 19marc70
19marc70 collected $1.32 from pot
19marc70: doesn't show hand 
*** SUMMARY ***
Total pot $1.38 | Rake $0.06 
Board [2d 5c 7d Td]
Seat 1: 19marc70 (button) collected ($1.32)
Seat 2: ysha76 (small blind) folded on the Turn
Seat 3: jinn171700 (big blind) folded before Flop
Seat 4: Andra.Andu folded before Flop (didn't bet)
Seat 5: Heian Tachi folded before Flop (didn't bet)
Seat 6: WI7ZZ folded before Flop (didn't bet)



PokerStars Zoom Hand #188747655431:  Hold'em No Limit ($0.05/$0.10) - 2018/07/15 13:08:27 WET [2018/07/15 8:08:27 ET]
Table 'Aludra' 6-max Seat #1 is the button
Seat 1: chipman28 ($6.35 in chips) 
Seat 2: WI7ZZ ($16.82 in chips) 
Seat 3: SharkyPrime ($5.16 in chips) 
Seat 4: hiroyamatic ($12.38 in chips) 
Seat 5: ahmat star ($4.70 in chips) 
Seat 6: andrewmitton ($11.16 in chips) 
WI7ZZ: posts small blind $0.05
SharkyPrime: posts big blind $0.10
*** HOLE CARDS ***
Dealt to WI7ZZ [2s Kc]
hiroyamatic: folds 
ahmat star: folds 
andrewmitton: raises $0.20 to $0.30
chipman28: folds 
WI7ZZ: folds 
SharkyPrime: folds 
Uncalled bet ($0.20) returned to andrewmitton
andrewmitton collected $0.25 from pot
andrewmitton: doesn't show hand 
*** SUMMARY ***
Total pot $0.25 | Rake $0 
Seat 1: chipman28 (button) folded before Flop (didn't bet)
Seat 2: WI7ZZ (small blind) folded before Flop
Seat 3: SharkyPrime (big blind) folded before Flop
Seat 4: hiroyamatic folded before Flop (didn't bet)
Seat 5: ahmat star folded before Flop (didn't bet)
Seat 6: andrewmitton collected ($0.25)



PokerStars Zoom Hand #188747664802:  Hold'em No Limit ($0.05/$0.10) - 2018/07/15 13:08:48 WET [2018/07/15 8:08:48 ET]
Table 'Aludra' 6-max Seat #1 is the button
Seat 1: anthony1480 ($7.42 in chips) 
Seat 2: Rude8oy9 ($12.58 in chips) 
Seat 3: GeorgtheLord ($10 in chips) 
Seat 4: Andra.Andu ($10.66 in chips) 
Seat 5: WI7ZZ ($16.77 in chips) 
Seat 6: migena87 ($8.73 in chips) 
Rude8oy9: posts small blind $0.05
GeorgtheLord: posts big blind $0.10
*** HOLE CARDS ***
Dealt to WI7ZZ [Kc Th]
Andra.Andu: folds 
WI7ZZ: raises $0.21 to $0.31
migena87: folds 
anthony1480: folds 
Rude8oy9: folds 
GeorgtheLord: calls $0.21
*** FLOP *** [8c 8s 8d]
GeorgtheLord: checks 
WI7ZZ: checks 
*** TURN *** [8c 8s 8d] [8h]
GeorgtheLord: checks 
WI7ZZ: bets $0.40
GeorgtheLord: folds 
Uncalled bet ($0.40) returned to WI7ZZ
WI7ZZ collected $0.64 from pot
WI7ZZ: doesn't show hand 
*** SUMMARY ***
Total pot $0.67 | Rake $0.03 
Board [8c 8s 8d 8h]
Seat 1: anthony1480 (button) folded before Flop (didn't bet)
Seat 2: Rude8oy9 (small blind) folded before Flop
Seat 3: GeorgtheLord (big blind) folded on the Turn
Seat 4: Andra.Andu folded before Flop (didn't bet)
Seat 5: WI7ZZ collected ($0.64)
Seat 6: migena87 folded before Flop (didn't bet)



PokerStars Zoom Hand #188747678689:  Hold'em No Limit ($0.05/$0.10) - 2018/07/15 13:09:19 WET [2018/07/15 8:09:19 ET]
Table 'Aludra' 6-max Seat #1 is the button
Seat 1: KlassicBoxer ($10 in chips) 
Seat 2: Andra.Andu ($10.05 in chips) 
Seat 3: WI7ZZ ($17.10 in chips) 
Seat 4: NikolaGR ($10.42 in chips) 
Seat 5: AK_lucky_AK ($10 in chips) 
Seat 6: R0888 ($8.90 in chips) 
Andra.Andu: posts small blind $0.05
WI7ZZ: posts big blind $0.10
*** HOLE CARDS ***
Dealt to WI7ZZ [4d Ad]
NikolaGR: raises $0.30 to $0.40
AK_lucky_AK: folds 
R0888: folds 
KlassicBoxer: folds 
Andra.Andu: folds 
WI7ZZ: calls $0.30
*** FLOP *** [2c Ts 8c]
WI7ZZ: checks 
NikolaGR: bets $0.60
WI7ZZ: folds 
Uncalled bet ($0.60) returned to NikolaGR
NikolaGR collected $0.81 from pot
*** SUMMARY ***
Total pot $0.85 | Rake $0.04 
Board [2c Ts 8c]
Seat 1: KlassicBoxer (button) folded before Flop (didn't bet)
Seat 2: Andra.Andu (small blind) folded before Flop
Seat 3: WI7ZZ (big blind) folded on the Flop
Seat 4: NikolaGR collected ($0.81)
Seat 5: AK_lucky_AK folded before Flop (didn't bet)
Seat 6: R0888 folded before Flop (didn't bet)



PokerStars Zoom Hand #188747687179:  Hold'em No Limit ($0.05/$0.10) - 2018/07/15 13:09:38 WET [2018/07/15 8:09:38 ET]
Table 'Aludra' 6-max Seat #1 is the button
Seat 1: WI7ZZ ($16.70 in chips) 
Seat 2: GrinPisik ($2.83 in chips) 
Seat 3: tamori14 ($13.48 in chips) 
Seat 4: incredibleuh ($18.04 in chips) 
Seat 5: JACKQ0007 ($13.16 in chips) 
Seat 6: 1_gaborik ($11.15 in chips) 
GrinPisik: posts small blind $0.05
tamori14: posts big blind $0.10
*** HOLE CARDS ***
Dealt to WI7ZZ [8d 2c]
incredibleuh: folds 
JACKQ0007: folds 
1_gaborik: folds 
WI7ZZ: folds 
GrinPisik: raises $0.10 to $0.20
tamori14: calls $0.10
*** FLOP *** [Qc Tc 7s]
GrinPisik: bets $0.40
tamori14: calls $0.40
*** TURN *** [Qc Tc 7s] [2d]
GrinPisik: bets $2.23 and is all-in
tamori14: calls $2.23
*** RIVER *** [Qc Tc 7s 2d] [Kc]
*** SHOW DOWN ***
GrinPisik: shows [Ah Ad] (a pair of Aces)
tamori14: shows [Qd Th] (two pair, Queens and Tens)
tamori14 collected $5.41 from pot
*** SUMMARY ***
Total pot $5.66 | Rake $0.25 
Board [Qc Tc 7s 2d Kc]
Seat 1: WI7ZZ (button) folded before Flop (didn't bet)
Seat 2: GrinPisik (small blind) showed [Ah Ad] and lost with a pair of Aces
Seat 3: tamori14 (big blind) showed [Qd Th] and won ($5.41) with two pair, Queens and Tens
Seat 4: incredibleuh folded before Flop (didn't bet)
Seat 5: JACKQ0007 folded before Flop (didn't bet)
Seat 6: 1_gaborik folded before Flop (didn't bet)



PokerStars Zoom Hand #188747688972:  Hold'em No Limit ($0.05/$0.10) - 2018/07/15 13:09:42 WET [2018/07/15 8:09:42 ET]
Table 'Aludra' 6-max Seat #1 is the button
Seat 1: Gevron ($36.29 in chips) 
Seat 2: Predtecha87 ($10 in chips) 
Seat 3: dmmace ($10.87 in chips) 
Seat 4: bubica0 ($6.70 in chips) 
Seat 5: SASHA127224 ($8.46 in chips) 
Seat 6: WI7ZZ ($16.70 in chips) 
Predtecha87: posts small blind $0.05
dmmace: posts big blind $0.10
*** HOLE CARDS ***
Dealt to WI7ZZ [Jd Td]
bubica0: folds 
SASHA127224 has timed out
SASHA127224: folds 
WI7ZZ: raises $0.21 to $0.31
Gevron: folds 
Predtecha87: folds 
dmmace: raises $0.67 to $0.98
WI7ZZ: calls $0.67
*** FLOP *** [3d 8c Ts]
dmmace: bets $1.20
WI7ZZ: raises $1.80 to $3
dmmace: calls $1.80
*** TURN *** [3d 8c Ts] [Jc]
dmmace: checks 
WI7ZZ: bets $3.37
dmmace: folds 
Uncalled bet ($3.37) returned to WI7ZZ
WI7ZZ collected $7.65 from pot
WI7ZZ: doesn't show hand 
*** SUMMARY ***
Total pot $8.01 | Rake $0.36 
Board [3d 8c Ts Jc]
Seat 1: Gevron (button) folded before Flop (didn't bet)
Seat 2: Predtecha87 (small blind) folded before Flop
Seat 3: dmmace (big blind) folded on the Turn
Seat 4: bubica0 folded before Flop (didn't bet)
Seat 5: SASHA127224 folded before Flop (didn't bet)
Seat 6: WI7ZZ collected ($7.65)



PokerStars Zoom Hand #188747728117:  Hold'em No Limit ($0.05/$0.10) - 2018/07/15 13:11:09 WET [2018/07/15 8:11:09 ET]
Table 'Aludra' 6-max Seat #1 is the button
Seat 1: pushi2 ($10 in chips) 
Seat 2: LionLin523 ($13.68 in chips) 
Seat 3: illuvatar125 ($10 in chips) 
Seat 4: jinn171700 ($4.72 in chips) 
Seat 5: WI7ZZ ($20.37 in chips) 
Seat 6: StackLizard ($11.55 in chips) 
LionLin523: posts small blind $0.05
illuvatar125: posts big blind $0.10
*** HOLE CARDS ***
Dealt to WI7ZZ [4s Ts]
jinn171700: folds 
WI7ZZ: folds 
StackLizard: folds 
pushi2: folds 
LionLin523: folds 
Uncalled bet ($0.05) returned to illuvatar125
illuvatar125 collected $0.10 from pot
illuvatar125: doesn't show hand 
*** SUMMARY ***
Total pot $0.10 | Rake $0 
Seat 1: pushi2 (button) folded before Flop (didn't bet)
Seat 2: LionLin523 (small blind) folded before Flop
Seat 3: illuvatar125 (big blind) collected ($0.10)
Seat 4: jinn171700 folded before Flop (didn't bet)
Seat 5: WI7ZZ folded before Flop (didn't bet)
Seat 6: StackLizard folded before Flop (didn't bet)



PokerStars Zoom Hand #188747729463:  Hold'em No Limit ($0.05/$0.10) - 2018/07/15 13:11:12 WET [2018/07/15 8:11:12 ET]
Table 'Aludra' 6-max Seat #1 is the button
Seat 1: unreal121 ($27.45 in chips) 
Seat 2: WI7ZZ ($20.37 in chips) 
Seat 3: mqsan ($15.34 in chips) 
Seat 4: rack1777 ($16.85 in chips) 
Seat 5: KeySssi ($11.08 in chips) 
Seat 6: kamikaza11 ($15.50 in chips) 
WI7ZZ: posts small blind $0.05
mqsan: posts big blind $0.10
*** HOLE CARDS ***
Dealt to WI7ZZ [Jd 3s]
rack1777: folds 
KeySssi: folds 
kamikaza11: folds 
unreal121: folds 
WI7ZZ: folds 
Uncalled bet ($0.05) returned to mqsan
mqsan collected $0.10 from pot
mqsan: doesn't show hand 
*** SUMMARY ***
Total pot $0.10 | Rake $0 
Seat 1: unreal121 (button) folded before Flop (didn't bet)
Seat 2: WI7ZZ (small blind) folded before Flop
Seat 3: mqsan (big blind) collected ($0.10)
Seat 4: rack1777 folded before Flop (didn't bet)
Seat 5: KeySssi folded before Flop (didn't bet)
Seat 6: kamikaza11 folded before Flop (didn't bet)



PokerStars Zoom Hand #188747730791:  Hold'em No Limit ($0.05/$0.10) - 2018/07/15 13:11:15 WET [2018/07/15 8:11:15 ET]
Table 'Aludra' 6-max Seat #1 is the button
Seat 1: XXschmidtX ($14 in chips) 
Seat 2: ruhaj ($10.90 in chips) 
Seat 3: WI7ZZ ($20.32 in chips) 
Seat 4: -=l Grek l=- ($19.52 in chips) 
Seat 5: lordx777 ($11.92 in chips) 
Seat 6: PEE0202 ($28.42 in chips) 
ruhaj: posts small blind $0.05
WI7ZZ: posts big blind $0.10
*** HOLE CARDS ***
Dealt to WI7ZZ [Qs As]
-=l Grek l=-: folds 
lordx777: folds 
PEE0202: raises $0.25 to $0.35
XXschmidtX: folds 
ruhaj: folds 
WI7ZZ: raises $0.70 to $1.05
PEE0202: calls $0.70
*** FLOP *** [4d 7d 5s]
WI7ZZ: bets $1.20
PEE0202: calls $1.20
*** TURN *** [4d 7d 5s] [Ts]
WI7ZZ: bets $1.91
PEE0202: calls $1.91
*** RIVER *** [4d 7d 5s Ts] [9c]
WI7ZZ: checks 
PEE0202: checks 
*** SHOW DOWN ***
WI7ZZ: shows [Qs As] (high card Ace)
PEE0202: shows [9d 8s] (a pair of Nines)
PEE0202 collected $7.99 from pot
*** SUMMARY ***
Total pot $8.37 | Rake $0.38 
Board [4d 7d 5s Ts 9c]
Seat 1: XXschmidtX (button) folded before Flop (didn't bet)
Seat 2: ruhaj (small blind) folded before Flop
Seat 3: WI7ZZ (big blind) showed [Qs As] and lost with high card Ace
Seat 4: -=l Grek l=- folded before Flop (didn't bet)
Seat 5: lordx777 folded before Flop (didn't bet)
Seat 6: PEE0202 showed [9d 8s] and won ($7.99) with a pair of Nines



PokerStars Zoom Hand #188747752845:  Hold'em No Limit ($0.05/$0.10) - 2018/07/15 13:12:04 WET [2018/07/15 8:12:04 ET]
Table 'Aludra' 6-max Seat #1 is the button
Seat 1: joedinskide ($4.37 in chips) 
Seat 2: Lily710 ($15.44 in chips) 
Seat 3: Easterdamn ($24.80 in chips) 
Seat 4: dekkki89 ($10.07 in chips) 
Seat 5: Tamexo ($17.88 in chips) 
Seat 6: WI7ZZ ($16.16 in chips) 
Lily710: posts small blind $0.05
Easterdamn: posts big blind $0.10
*** HOLE CARDS ***
Dealt to WI7ZZ [Ac Tc]
dekkki89: folds 
Tamexo: folds 
WI7ZZ: raises $0.21 to $0.31
joedinskide: folds 
Lily710: folds 
Easterdamn: folds 
Uncalled bet ($0.21) returned to WI7ZZ
WI7ZZ collected $0.25 from pot
WI7ZZ: doesn't show hand 
*** SUMMARY ***
Total pot $0.25 | Rake $0 
Seat 1: joedinskide (button) folded before Flop (didn't bet)
Seat 2: Lily710 (small blind) folded before Flop
Seat 3: Easterdamn (big blind) folded before Flop
Seat 4: dekkki89 folded before Flop (didn't bet)
Seat 5: Tamexo folded before Flop (didn't bet)
Seat 6: WI7ZZ collected ($0.25)



PokerStars Zoom Hand #188747762405:  Hold'em No Limit ($0.05/$0.10) - 2018/07/15 13:12:25 WET [2018/07/15 8:12:25 ET]
Table 'Aludra' 6-max Seat #1 is the button
Seat 1: WI7ZZ ($16.31 in chips) 
Seat 2: jump9922 ($11.31 in chips) 
Seat 3: Rude8oy9 ($11.93 in chips) 
Seat 4: QuakieMan ($10.20 in chips) 
Seat 5: KeySssi ($18.86 in chips) 
Seat 6: funkyleo ($10.67 in chips) 
jump9922: posts small blind $0.05
Rude8oy9: posts big blind $0.10
*** HOLE CARDS ***
Dealt to WI7ZZ [Td 5s]
QuakieMan: folds 
KeySssi: raises $0.15 to $0.25
funkyleo: folds 
WI7ZZ: folds 
jump9922: calls $0.20
Rude8oy9: folds 
*** FLOP *** [9h 9c Ad]
jump9922: checks 
KeySssi: checks 
*** TURN *** [9h 9c Ad] [8s]
jump9922: checks 
KeySssi: bets $0.26
jump9922: calls $0.26
*** RIVER *** [9h 9c Ad 8s] [Tc]
jump9922: checks 
KeySssi: bets $0.70
jump9922: folds 
Uncalled bet ($0.70) returned to KeySssi
KeySssi collected $1.07 from pot
KeySssi: doesn't show hand 
*** SUMMARY ***
Total pot $1.12 | Rake $0.05 
Board [9h 9c Ad 8s Tc]
Seat 1: WI7ZZ (button) folded before Flop (didn't bet)
Seat 2: jump9922 (small blind) folded on the River
Seat 3: Rude8oy9 (big blind) folded before Flop
Seat 4: QuakieMan folded before Flop (didn't bet)
Seat 5: KeySssi collected ($1.07)
Seat 6: funkyleo folded before Flop (didn't bet)



PokerStars Zoom Hand #188747793993:  Hold'em No Limit ($0.05/$0.10) - 2018/07/15 13:13:35 WET [2018/07/15 8:13:35 ET]
Table 'Aludra' 6-max Seat #1 is the button
Seat 1: hellf1re666 ($11.84 in chips) 
Seat 2: WI7ZZ ($16.31 in chips) 
Seat 3: Mukshinskijj ($15.06 in chips) 
Seat 4: SKD TEAM PRO ($10.13 in chips) 
Seat 5: evathia ($11.73 in chips) 
Seat 6: SuDDen1991 ($31.04 in chips) 
WI7ZZ: posts small blind $0.05
Mukshinskijj: posts big blind $0.10
*** HOLE CARDS ***
Dealt to WI7ZZ [Th 3s]
SKD TEAM PRO: folds 
evathia: folds 
SuDDen1991: folds 
hellf1re666: raises $0.19 to $0.29
WI7ZZ: folds 
Mukshinskijj: folds 
Uncalled bet ($0.19) returned to hellf1re666
hellf1re666 collected $0.25 from pot
hellf1re666: doesn't show hand 
*** SUMMARY ***
Total pot $0.25 | Rake $0 
Seat 1: hellf1re666 (button) collected ($0.25)
Seat 2: WI7ZZ (small blind) folded before Flop
Seat 3: Mukshinskijj (big blind) folded before Flop
Seat 4: SKD TEAM PRO folded before Flop (didn't bet)
Seat 5: evathia folded before Flop (didn't bet)
Seat 6: SuDDen1991 folded before Flop (didn't bet)



PokerStars Zoom Hand #188747795365:  Hold'em No Limit ($0.05/$0.10) - 2018/07/15 13:13:38 WET [2018/07/15 8:13:38 ET]
Table 'Aludra' 6-max Seat #1 is the button
Seat 1: fado31 ($10.02 in chips) 
Seat 2: ElonzIllesc ($11.35 in chips) 
Seat 3: WI7ZZ ($16.26 in chips) 
Seat 4: Andra.Andu ($10.63 in chips) 
Seat 5: unreal121 ($27.72 in chips) 
Seat 6: mqsan ($10 in chips) 
ElonzIllesc: posts small blind $0.05
WI7ZZ: posts big blind $0.10
*** HOLE CARDS ***
Dealt to WI7ZZ [Td 9d]
Andra.Andu: folds 
unreal121: folds 
mqsan: folds 
fado31: calls $0.10
ElonzIllesc: folds 
WI7ZZ: raises $0.20 to $0.30
fado31: calls $0.20
*** FLOP *** [7c Ah Ac]
WI7ZZ: checks 
fado31: checks 
*** TURN *** [7c Ah Ac] [6s]
WI7ZZ: bets $0.27
fado31: folds 
Uncalled bet ($0.27) returned to WI7ZZ
WI7ZZ collected $0.62 from pot
WI7ZZ: doesn't show hand 
*** SUMMARY ***
Total pot $0.65 | Rake $0.03 
Board [7c Ah Ac 6s]
Seat 1: fado31 (button) folded on the Turn
Seat 2: ElonzIllesc (small blind) folded before Flop
Seat 3: WI7ZZ (big blind) collected ($0.62)
Seat 4: Andra.Andu folded before Flop (didn't bet)
Seat 5: unreal121 folded before Flop (didn't bet)
Seat 6: mqsan folded before Flop (didn't bet)



PokerStars Zoom Hand #188747791311:  Hold'em No Limit ($0.05/$0.10) - 2018/07/15 13:13:29 WET [2018/07/15 8:13:29 ET]
Table 'Aludra' 6-max Seat #1 is the button
Seat 1: Juurikas ($10 in chips) 
Seat 2: jump9922 ($21.31 in chips) 
Seat 3: filifera ($6.05 in chips) 
Seat 4: WI7ZZ ($16.31 in chips) 
Seat 5: gift-cloud9 ($11.35 in chips) 
Seat 6: rack1777 ($14.44 in chips) 
jump9922: posts small blind $0.05
filifera: posts big blind $0.10
*** HOLE CARDS ***
Dealt to WI7ZZ [2c Td]
WI7ZZ: folds 
gift-cloud9: folds 
rack1777: folds 
Juurikas: folds 
jump9922: raises $0.30 to $0.40
filifera: calls $0.30
*** FLOP *** [4s 2s 7c]
jump9922: bets $0.51
filifera: calls $0.51
*** TURN *** [4s 2s 7c] [Jh]
jump9922: checks 
filifera: bets $1
jump9922: folds 
Uncalled bet ($1) returned to filifera
filifera collected $1.74 from pot
filifera: doesn't show hand 
*** SUMMARY ***
Total pot $1.82 | Rake $0.08 
Board [4s 2s 7c Jh]
Seat 1: Juurikas (button) folded before Flop (didn't bet)
Seat 2: jump9922 (small blind) folded on the Turn
Seat 3: filifera (big blind) collected ($1.74)
Seat 4: WI7ZZ folded before Flop (didn't bet)
Seat 5: gift-cloud9 folded before Flop (didn't bet)
Seat 6: rack1777 folded before Flop (didn't bet)



PokerStars Zoom Hand #188747811717:  Hold'em No Limit ($0.05/$0.10) - 2018/07/15 13:14:14 WET [2018/07/15 8:14:14 ET]
Table 'Aludra' 6-max Seat #1 is the button
Seat 1: 0201yuta ($11.16 in chips) 
Seat 2: josecarafre ($4.17 in chips) 
Seat 3: Lazy_dog[ru] ($10 in chips) 
Seat 4: tiodor1972 ($10.03 in chips) 
Seat 5: WI7ZZ ($16.58 in chips) 
Seat 6: JACKQ0007 ($13.18 in chips) 
josecarafre: posts small blind $0.05
Lazy_dog[ru]: posts big blind $0.10
*** HOLE CARDS ***
Dealt to WI7ZZ [5h 8c]
tiodor1972: folds 
WI7ZZ: folds 
JACKQ0007: folds 
0201yuta: folds 
josecarafre: folds 
Uncalled bet ($0.05) returned to Lazy_dog[ru]
Lazy_dog[ru] collected $0.10 from pot
Lazy_dog[ru]: doesn't show hand 
*** SUMMARY ***
Total pot $0.10 | Rake $0 
Seat 1: 0201yuta (button) folded before Flop (didn't bet)
Seat 2: josecarafre (small blind) folded before Flop
Seat 3: Lazy_dog[ru] (big blind) collected ($0.10)
Seat 4: tiodor1972 folded before Flop (didn't bet)
Seat 5: WI7ZZ folded before Flop (didn't bet)
Seat 6: JACKQ0007 folded before Flop (didn't bet)



PokerStars Zoom Hand #188747808507:  Hold'em No Limit ($0.05/$0.10) - 2018/07/15 13:14:07 WET [2018/07/15 8:14:07 ET]
Table 'Aludra' 6-max Seat #1 is the button
Seat 1: Zimniy ($10 in chips) 
Seat 2: Robertc1977 ($7.33 in chips) 
Seat 3: QuakieMan ($31.93 in chips) 
Seat 4: 1_gaborik ($11.14 in chips) 
Seat 5: Tobberandom ($10.61 in chips) 
Seat 6: WI7ZZ ($16.58 in chips) 
Robertc1977: posts small blind $0.05
QuakieMan: posts big blind $0.10
*** HOLE CARDS ***
Dealt to WI7ZZ [3s Th]
1_gaborik: folds 
Tobberandom: folds 
WI7ZZ: folds 
Zimniy: folds 
Robertc1977: folds 
Uncalled bet ($0.05) returned to QuakieMan
QuakieMan collected $0.10 from pot
QuakieMan: doesn't show hand 
*** SUMMARY ***
Total pot $0.10 | Rake $0 
Seat 1: Zimniy (button) folded before Flop (didn't bet)
Seat 2: Robertc1977 (small blind) folded before Flop
Seat 3: QuakieMan (big blind) collected ($0.10)
Seat 4: 1_gaborik folded before Flop (didn't bet)
Seat 5: Tobberandom folded before Flop (didn't bet)
Seat 6: WI7ZZ folded before Flop (didn't bet)



PokerStars Zoom Hand #188747813151:  Hold'em No Limit ($0.05/$0.10) - 2018/07/15 13:14:17 WET [2018/07/15 8:14:17 ET]
Table 'Aludra' 6-max Seat #1 is the button
Seat 1: WI7ZZ ($16.58 in chips) 
Seat 2: anakinn888 ($4.21 in chips) 
Seat 3: scotseng ($8.36 in chips) 
Seat 4: cbazsi ($11.27 in chips) 
Seat 5: filifera ($6.88 in chips) 
Seat 6: PleyaDeanS ($21.74 in chips) 
anakinn888: posts small blind $0.05
scotseng: posts big blind $0.10
*** HOLE CARDS ***
Dealt to WI7ZZ [Ts 4s]
cbazsi: folds 
filifera: folds 
PleyaDeanS: folds 
WI7ZZ: folds 
anakinn888: raises $0.20 to $0.30
scotseng: folds 
Uncalled bet ($0.20) returned to anakinn888
anakinn888 collected $0.20 from pot
anakinn888: doesn't show hand 
*** SUMMARY ***
Total pot $0.20 | Rake $0 
Seat 1: WI7ZZ (button) folded before Flop (didn't bet)
Seat 2: anakinn888 (small blind) collected ($0.20)
Seat 3: scotseng (big blind) folded before Flop
Seat 4: cbazsi folded before Flop (didn't bet)
Seat 5: filifera folded before Flop (didn't bet)
Seat 6: PleyaDeanS folded before Flop (didn't bet)



PokerStars Zoom Hand #188747818532:  Hold'em No Limit ($0.05/$0.10) - 2018/07/15 13:14:29 WET [2018/07/15 8:14:29 ET]
Table 'Aludra' 6-max Seat #1 is the button
Seat 1: focus480 ($11.35 in chips) 
Seat 2: RichB21 ($5.52 in chips) 
Seat 3: NikolaGR ($10.50 in chips) 
Seat 4: WI7ZZ ($16.53 in chips) 
Seat 5: raisiden ($5.45 in chips) 
Seat 6: Toxa512 ($18.22 in chips) 
RichB21: posts small blind $0.05
NikolaGR: posts big blind $0.10
*** HOLE CARDS ***
Dealt to WI7ZZ [Kh 3s]
WI7ZZ: folds 
raisiden: raises $0.20 to $0.30
Toxa512: folds 
focus480: folds 
RichB21: folds 
NikolaGR: folds 
Uncalled bet ($0.20) returned to raisiden
raisiden collected $0.25 from pot
raisiden: doesn't show hand 
*** SUMMARY ***
Total pot $0.25 | Rake $0 
Seat 1: focus480 (button) folded before Flop (didn't bet)
Seat 2: RichB21 (small blind) folded before Flop
Seat 3: NikolaGR (big blind) folded before Flop
Seat 4: WI7ZZ folded before Flop (didn't bet)
Seat 5: raisiden collected ($0.25)
Seat 6: Toxa512 folded before Flop (didn't bet)



PokerStars Zoom Hand #188747815816:  Hold'em No Limit ($0.05/$0.10) - 2018/07/15 13:14:23 WET [2018/07/15 8:14:23 ET]
Table 'Aludra' 6-max Seat #1 is the button
Seat 1: bubica0 ($8.75 in chips) 
Seat 2: WI7ZZ ($16.58 in chips) 
Seat 3: Midway2 ($8.27 in chips) 
Seat 4: Bet-3Bet-Push ($15.72 in chips) 
Seat 5: der9bin ($12.70 in chips) 
Seat 6: icharliee ($12.63 in chips) 
WI7ZZ: posts small blind $0.05
Midway2: posts big blind $0.10
*** HOLE CARDS ***
Dealt to WI7ZZ [9s 2s]
Bet-3Bet-Push: folds 
der9bin: raises $0.25 to $0.35
icharliee: folds 
bubica0: folds 
WI7ZZ: folds 
Midway2: calls $0.25
*** FLOP *** [Ad Qs Ks]
Midway2: checks 
der9bin: bets $0.40
Midway2: calls $0.40
*** TURN *** [Ad Qs Ks] [3s]
Midway2: checks 
der9bin: checks 
*** RIVER *** [Ad Qs Ks 3s] [6c]
Midway2: checks 
der9bin: checks 
*** SHOW DOWN ***
Midway2: shows [Kh Jh] (a pair of Kings)
der9bin: shows [Js Ac] (a pair of Aces)
der9bin collected $1.48 from pot
*** SUMMARY ***
Total pot $1.55 | Rake $0.07 
Board [Ad Qs Ks 3s 6c]
Seat 1: bubica0 (button) folded before Flop (didn't bet)
Seat 2: WI7ZZ (small blind) folded before Flop
Seat 3: Midway2 (big blind) showed [Kh Jh] and lost with a pair of Kings
Seat 4: Bet-3Bet-Push folded before Flop (didn't bet)
Seat 5: der9bin showed [Js Ac] and won ($1.48) with a pair of Aces
Seat 6: icharliee folded before Flop (didn't bet)



PokerStars Zoom Hand #188747820404:  Hold'em No Limit ($0.05/$0.10) - 2018/07/15 13:14:33 WET [2018/07/15 8:14:33 ET]
Table 'Aludra' 6-max Seat #1 is the button
Seat 1: XXschmidtX ($11.33 in chips) 
Seat 2: LulaBluff ($8.16 in chips) 
Seat 3: kamikaza11 ($24.43 in chips) 
Seat 4: 0201yuta ($13.93 in chips) 
Seat 5: WI7ZZ ($16.53 in chips) 
Seat 6: hiroyamatic ($14.04 in chips) 
LulaBluff: posts small blind $0.05
kamikaza11: posts big blind $0.10
*** HOLE CARDS ***
Dealt to WI7ZZ [4h 8d]
0201yuta: folds 
WI7ZZ: folds 
hiroyamatic: folds 
XXschmidtX: raises $0.12 to $0.22
LulaBluff: folds 
kamikaza11: calls $0.12
*** FLOP *** [Qd 2s 5c]
kamikaza11: checks 
XXschmidtX: bets $0.24
kamikaza11: folds 
Uncalled bet ($0.24) returned to XXschmidtX
XXschmidtX collected $0.47 from pot
XXschmidtX: doesn't show hand 
*** SUMMARY ***
Total pot $0.49 | Rake $0.02 
Board [Qd 2s 5c]
Seat 1: XXschmidtX (button) collected ($0.47)
Seat 2: LulaBluff (small blind) folded before Flop
Seat 3: kamikaza11 (big blind) folded on the Flop
Seat 4: 0201yuta folded before Flop (didn't bet)
Seat 5: WI7ZZ folded before Flop (didn't bet)
Seat 6: hiroyamatic folded before Flop (didn't bet)



PokerStars Zoom Hand #188747822762:  Hold'em No Limit ($0.05/$0.10) - 2018/07/15 13:14:38 WET [2018/07/15 8:14:38 ET]
Table 'Aludra' 6-max Seat #1 is the button
Seat 1: Teletotti ($10 in chips) 
Seat 2: 1_gaborik ($12.86 in chips) 
Seat 3: WI7ZZ ($16.53 in chips) 
Seat 4: ChungkingExp ($12.18 in chips) 
Seat 5: MOU77Y ($13.82 in chips) 
Seat 6: Lazy_dog[ru] ($11.28 in chips) 
1_gaborik: posts small blind $0.05
WI7ZZ: posts big blind $0.10
*** HOLE CARDS ***
Dealt to WI7ZZ [5d 3s]
ChungkingExp: folds 
MOU77Y: folds 
Lazy_dog[ru]: folds 
Teletotti: folds 
1_gaborik: calls $0.05
WI7ZZ: checks 
*** FLOP *** [Jd 4c 8h]
1_gaborik: checks 
WI7ZZ: checks 
*** TURN *** [Jd 4c 8h] [Tc]
1_gaborik: bets $0.10
WI7ZZ: folds 
Uncalled bet ($0.10) returned to 1_gaborik
1_gaborik collected $0.19 from pot
1_gaborik: doesn't show hand 
*** SUMMARY ***
Total pot $0.20 | Rake $0.01 
Board [Jd 4c 8h Tc]
Seat 1: Teletotti (button) folded before Flop (didn't bet)
Seat 2: 1_gaborik (small blind) collected ($0.19)
Seat 3: WI7ZZ (big blind) folded on the Turn
Seat 4: ChungkingExp folded before Flop (didn't bet)
Seat 5: MOU77Y folded before Flop (didn't bet)
Seat 6: Lazy_dog[ru] folded before Flop (didn't bet)



PokerStars Zoom Hand #188747832190:  Hold'em No Limit ($0.05/$0.10) - 2018/07/15 13:14:59 WET [2018/07/15 8:14:59 ET]
Table 'Aludra' 6-max Seat #1 is the button
Seat 1: WI7ZZ ($16.43 in chips) 
Seat 2: meser63371 ($13.95 in chips) 
Seat 3: abc11310 ($14 in chips) 
Seat 4: vkartmann ($14.74 in chips) 
Seat 5: bigtpax ($6.83 in chips) 
Seat 6: XXschmidtX ($11.58 in chips) 
meser63371: posts small blind $0.05
abc11310: posts big blind $0.10
*** HOLE CARDS ***
Dealt to WI7ZZ [Jc 9c]
vkartmann: folds 
bigtpax: raises $0.15 to $0.25
XXschmidtX: folds 
WI7ZZ: calls $0.25
meser63371: folds 
abc11310: calls $0.15
*** FLOP *** [7d 2h 3d]
abc11310: checks 
bigtpax: checks 
WI7ZZ: checks 
*** TURN *** [7d 2h 3d] [Qh]
abc11310: checks 
bigtpax: checks 
WI7ZZ: bets $0.33
abc11310: folds 
bigtpax: folds 
Uncalled bet ($0.33) returned to WI7ZZ
WI7ZZ collected $0.76 from pot
WI7ZZ: doesn't show hand 
*** SUMMARY ***
Total pot $0.80 | Rake $0.04 
Board [7d 2h 3d Qh]
Seat 1: WI7ZZ (button) collected ($0.76)
Seat 2: meser63371 (small blind) folded before Flop
Seat 3: abc11310 (big blind) folded on the Turn
Seat 4: vkartmann folded before Flop (didn't bet)
Seat 5: bigtpax folded on the Turn
Seat 6: XXschmidtX folded before Flop (didn't bet)



PokerStars Zoom Hand #188747863984:  Hold'em No Limit ($0.05/$0.10) - 2018/07/15 13:16:08 WET [2018/07/15 8:16:08 ET]
Table 'Aludra' 6-max Seat #1 is the button
Seat 1: Denchik_Vbg ($8.23 in chips) 
Seat 2: ume1234 ($10 in chips) 
Seat 3: ChungkingExp ($19.90 in chips) 
Seat 4: ysha76 ($14.73 in chips) 
Seat 5: Spooks1337 ($14.57 in chips) 
Seat 6: WI7ZZ ($16.94 in chips) 
ume1234: posts small blind $0.05
ChungkingExp: posts big blind $0.10
*** HOLE CARDS ***
Dealt to WI7ZZ [4d 7d]
ysha76: raises $0.20 to $0.30
Spooks1337: folds 
WI7ZZ: folds 
Denchik_Vbg: folds 
ume1234: folds 
ChungkingExp: calls $0.20
*** FLOP *** [6d 8h 6h]
ChungkingExp: checks 
ysha76: checks 
*** TURN *** [6d 8h 6h] [4h]
ChungkingExp: bets $0.35
ysha76: raises $0.35 to $0.70
ChungkingExp: calls $0.35
*** RIVER *** [6d 8h 6h 4h] [2h]
ChungkingExp: checks 
ysha76: bets $2
ChungkingExp: folds 
Uncalled bet ($2) returned to ysha76
ysha76 collected $1.96 from pot
ysha76: doesn't show hand 
*** SUMMARY ***
Total pot $2.05 | Rake $0.09 
Board [6d 8h 6h 4h 2h]
Seat 1: Denchik_Vbg (button) folded before Flop (didn't bet)
Seat 2: ume1234 (small blind) folded before Flop
Seat 3: ChungkingExp (big blind) folded on the River
Seat 4: ysha76 collected ($1.96)
Seat 5: Spooks1337 folded before Flop (didn't bet)
Seat 6: WI7ZZ folded before Flop (didn't bet)



PokerStars Zoom Hand #188747864871:  Hold'em No Limit ($0.05/$0.10) - 2018/07/15 13:16:10 WET [2018/07/15 8:16:10 ET]
Table 'Aludra' 6-max Seat #1 is the button
Seat 1: vasyabeer ($4.15 in chips) 
Seat 2: IcePunishU ($24.95 in chips) 
Seat 3: dan00581 ($10.70 in chips) 
Seat 4: WI7ZZ ($16.94 in chips) 
Seat 5: hellf1re666 ($13.29 in chips) 
Seat 6: S@gramor ($68.92 in chips) 
IcePunishU: posts small blind $0.05
dan00581: posts big blind $0.10
*** HOLE CARDS ***
Dealt to WI7ZZ [4d Kh]
WI7ZZ: folds 
hellf1re666: folds 
S@gramor: raises $0.15 to $0.25
vasyabeer: calls $0.25
IcePunishU: folds 
dan00581: calls $0.15
*** FLOP *** [Ks Tc 6d]
dan00581: checks 
S@gramor: checks 
vasyabeer: checks 
*** TURN *** [Ks Tc 6d] [3d]
dan00581: bets $0.50
S@gramor: folds 
vasyabeer: calls $0.50
*** RIVER *** [Ks Tc 6d 3d] [2h]
dan00581: bets $1.10
vasyabeer: calls $1.10
*** SHOW DOWN ***
dan00581: shows [9h Qh] (high card King)
vasyabeer: shows [Jc Ts] (a pair of Tens)
vasyabeer collected $3.82 from pot
*** SUMMARY ***
Total pot $4 | Rake $0.18 
Board [Ks Tc 6d 3d 2h]
Seat 1: vasyabeer (button) showed [Jc Ts] and won ($3.82) with a pair of Tens
Seat 2: IcePunishU (small blind) folded before Flop
Seat 3: dan00581 (big blind) showed [9h Qh] and lost with high card King
Seat 4: WI7ZZ folded before Flop (didn't bet)
Seat 5: hellf1re666 folded before Flop (didn't bet)
Seat 6: S@gramor folded on the Turn



PokerStars Zoom Hand #188747866639:  Hold'em No Limit ($0.05/$0.10) - 2018/07/15 13:16:14 WET [2018/07/15 8:16:14 ET]
Table 'Aludra' 6-max Seat #1 is the button
Seat 1: Only_Vizard ($11.45 in chips) 
Seat 2: WI7ZZ ($16.94 in chips) 
Seat 3: THE DOG#9 ($12.35 in chips) 
Seat 4: kotlecior ($10 in chips) 
Seat 5: Anton93726 ($9.65 in chips) 
Seat 6: Lily710 ($15.39 in chips) 
WI7ZZ: posts small blind $0.05
THE DOG#9: posts big blind $0.10
*** HOLE CARDS ***
Dealt to WI7ZZ [8s Ac]
kotlecior: folds 
Anton93726: folds 
Lily710: folds 
Only_Vizard: raises $0.12 to $0.22
WI7ZZ: calls $0.17
THE DOG#9: calls $0.12
*** FLOP *** [Jd 4s 5d]
WI7ZZ: checks 
THE DOG#9: checks 
Only_Vizard: checks 
*** TURN *** [Jd 4s 5d] [Jc]
WI7ZZ: checks 
THE DOG#9: checks 
Only_Vizard: bets $0.42
WI7ZZ: folds 
THE DOG#9: folds 
Uncalled bet ($0.42) returned to Only_Vizard
Only_Vizard collected $0.63 from pot
Only_Vizard: doesn't show hand 
*** SUMMARY ***
Total pot $0.66 | Rake $0.03 
Board [Jd 4s 5d Jc]
Seat 1: Only_Vizard (button) collected ($0.63)
Seat 2: WI7ZZ (small blind) folded on the Turn
Seat 3: THE DOG#9 (big blind) folded on the Turn
Seat 4: kotlecior folded before Flop (didn't bet)
Seat 5: Anton93726 folded before Flop (didn't bet)
Seat 6: Lily710 folded before Flop (didn't bet)



PokerStars Zoom Hand #188747892686:  Hold'em No Limit ($0.05/$0.10) - 2018/07/15 13:17:11 WET [2018/07/15 8:17:11 ET]
Table 'Aludra' 6-max Seat #1 is the button
Seat 1: der9bin ($13.15 in chips) 
Seat 2: chicmills ($9.90 in chips) 
Seat 3: SuDDen1991 ($11.53 in chips) 
Seat 4: Marsiz ($10.78 in chips) 
Seat 5: KlassicBoxer ($15.42 in chips) 
Seat 6: WI7ZZ ($16.72 in chips) 
chicmills: posts small blind $0.05
SuDDen1991: posts big blind $0.10
*** HOLE CARDS ***
Dealt to WI7ZZ [9s 6d]
Marsiz: folds 
KlassicBoxer: folds 
WI7ZZ: folds 
der9bin: folds 
chicmills: folds 
Uncalled bet ($0.05) returned to SuDDen1991
SuDDen1991 collected $0.10 from pot
SuDDen1991: doesn't show hand 
*** SUMMARY ***
Total pot $0.10 | Rake $0 
Seat 1: der9bin (button) folded before Flop (didn't bet)
Seat 2: chicmills (small blind) folded before Flop
Seat 3: SuDDen1991 (big blind) collected ($0.10)
Seat 4: Marsiz folded before Flop (didn't bet)
Seat 5: KlassicBoxer folded before Flop (didn't bet)
Seat 6: WI7ZZ folded before Flop (didn't bet)



PokerStars Zoom Hand #188747894054:  Hold'em No Limit ($0.05/$0.10) - 2018/07/15 13:17:14 WET [2018/07/15 8:17:14 ET]
Table 'Aludra' 6-max Seat #1 is the button
Seat 1: Diamond-PL ($12.83 in chips) 
Seat 2: Sheremetov88 ($18.64 in chips) 
Seat 3: WI7ZZ ($16.72 in chips) 
Seat 4: Midway2 ($14.98 in chips) 
Seat 5: littbar ($14.35 in chips) 
Seat 6: I'mYourTeddy ($19.06 in chips) 
Sheremetov88: posts small blind $0.05
WI7ZZ: posts big blind $0.10
*** HOLE CARDS ***
Dealt to WI7ZZ [Jd 2s]
Midway2: folds 
littbar: folds 
I'mYourTeddy: folds 
Diamond-PL: folds 
Sheremetov88: raises $0.10 to $0.20
WI7ZZ: folds 
Uncalled bet ($0.10) returned to Sheremetov88
Sheremetov88 collected $0.20 from pot
*** SUMMARY ***
Total pot $0.20 | Rake $0 
Seat 1: Diamond-PL (button) folded before Flop (didn't bet)
Seat 2: Sheremetov88 (small blind) collected ($0.20)
Seat 3: WI7ZZ (big blind) folded before Flop
Seat 4: Midway2 folded before Flop (didn't bet)
Seat 5: littbar folded before Flop (didn't bet)
Seat 6: I'mYourTeddy folded before Flop (didn't bet)



PokerStars Zoom Hand #188747890441:  Hold'em No Limit ($0.05/$0.10) - 2018/07/15 13:17:06 WET [2018/07/15 8:17:06 ET]
Table 'Aludra' 6-max Seat #1 is the button
Seat 1: Denchik_Vbg ($8.08 in chips) 
Seat 2: cbazsi ($9.59 in chips) 
Seat 3: vasyabeer ($6.12 in chips) 
Seat 4: WI7ZZ ($16.72 in chips) 
Seat 5: kazyunok ($10 in chips) 
Seat 6: scotseng ($7.67 in chips) 
cbazsi: posts small blind $0.05
vasyabeer: posts big blind $0.10
*** HOLE CARDS ***
Dealt to WI7ZZ [6c Jd]
WI7ZZ: folds 
kazyunok: folds 
scotseng: folds 
Denchik_Vbg: folds 
cbazsi: folds 
Uncalled bet ($0.05) returned to vasyabeer
vasyabeer collected $0.10 from pot
vasyabeer: doesn't show hand 
*** SUMMARY ***
Total pot $0.10 | Rake $0 
Seat 1: Denchik_Vbg (button) folded before Flop (didn't bet)
Seat 2: cbazsi (small blind) folded before Flop
Seat 3: vasyabeer (big blind) collected ($0.10)
Seat 4: WI7ZZ folded before Flop (didn't bet)
Seat 5: kazyunok folded before Flop (didn't bet)
Seat 6: scotseng folded before Flop (didn't bet)



PokerStars Zoom Hand #188747899992:  Hold'em No Limit ($0.05/$0.10) - 2018/07/15 13:17:27 WET [2018/07/15 8:17:27 ET]
Table 'Aludra' 6-max Seat #1 is the button
Seat 1: WI7ZZ ($16.62 in chips) 
Seat 2: QuocTuong ($16.46 in chips) 
Seat 3: AK_lucky_AK ($10 in chips) 
Seat 4: PeterSuker ($21.09 in chips) 
Seat 5: Tamexo ($17.81 in chips) 
Seat 6: Predtecha87 ($13.21 in chips) 
QuocTuong: posts small blind $0.05
AK_lucky_AK: posts big blind $0.10
*** HOLE CARDS ***
Dealt to WI7ZZ [Ah 5c]
PeterSuker: raises $0.15 to $0.25
Tamexo: folds 
Predtecha87: folds 
WI7ZZ: calls $0.25
QuocTuong: folds 
AK_lucky_AK: folds 
*** FLOP *** [3s Tc 6h]
PeterSuker: bets $0.30
WI7ZZ: folds 
Uncalled bet ($0.30) returned to PeterSuker
PeterSuker collected $0.62 from pot
*** SUMMARY ***
Total pot $0.65 | Rake $0.03 
Board [3s Tc 6h]
Seat 1: WI7ZZ (button) folded on the Flop
Seat 2: QuocTuong (small blind) folded before Flop
Seat 3: AK_lucky_AK (big blind) folded before Flop
Seat 4: PeterSuker collected ($0.62)
Seat 5: Tamexo folded before Flop (didn't bet)
Seat 6: Predtecha87 folded before Flop (didn't bet)



PokerStars Zoom Hand #188747914355:  Hold'em No Limit ($0.05/$0.10) - 2018/07/15 13:17:58 WET [2018/07/15 8:17:58 ET]
Table 'Aludra' 6-max Seat #1 is the button
Seat 1: evathia ($10.58 in chips) 
Seat 2: wwfzfjiv ($12.52 in chips) 
Seat 3: jairín_sá ($5.85 in chips) 
Seat 4: calthedude ($18.66 in chips) 
Seat 5: WI7ZZ ($16.37 in chips) 
Seat 6: scotseng ($8.07 in chips) 
wwfzfjiv: posts small blind $0.05
jairín_sá: posts big blind $0.10
*** HOLE CARDS ***
Dealt to WI7ZZ [7c 3h]
calthedude: folds 
WI7ZZ: folds 
scotseng: raises $0.10 to $0.20
evathia: folds 
wwfzfjiv: folds 
jairín_sá: calls $0.10
*** FLOP *** [Ac 6c Kh]
jairín_sá: checks 
scotseng: bets $0.10
jairín_sá: folds 
Uncalled bet ($0.10) returned to scotseng
scotseng collected $0.43 from pot
scotseng: doesn't show hand 
*** SUMMARY ***
Total pot $0.45 | Rake $0.02 
Board [Ac 6c Kh]
Seat 1: evathia (button) folded before Flop (didn't bet)
Seat 2: wwfzfjiv (small blind) folded before Flop
Seat 3: jairín_sá (big blind) folded on the Flop
Seat 4: calthedude folded before Flop (didn't bet)
Seat 5: WI7ZZ folded before Flop (didn't bet)
Seat 6: scotseng collected ($0.43)



PokerStars Zoom Hand #188747922058:  Hold'em No Limit ($0.05/$0.10) - 2018/07/15 13:18:15 WET [2018/07/15 8:18:15 ET]
Table 'Aludra' 6-max Seat #1 is the button
Seat 1: mir0417 ($16.20 in chips) 
Seat 2: PEE0202 ($11.09 in chips) 
Seat 3: WI7ZZ ($16.37 in chips) 
Seat 4: kotlecior ($10.23 in chips) 
Seat 5: Zimniy ($12.33 in chips) 
Seat 6: jump9922 ($17.71 in chips) 
PEE0202: posts small blind $0.05
WI7ZZ: posts big blind $0.10
*** HOLE CARDS ***
Dealt to WI7ZZ [4s 7d]
kotlecior: folds 
Zimniy: raises $0.15 to $0.25
jump9922: folds 
mir0417: folds 
PEE0202: folds 
WI7ZZ: folds 
Uncalled bet ($0.15) returned to Zimniy
Zimniy collected $0.25 from pot
Zimniy: doesn't show hand 
*** SUMMARY ***
Total pot $0.25 | Rake $0 
Seat 1: mir0417 (button) folded before Flop (didn't bet)
Seat 2: PEE0202 (small blind) folded before Flop
Seat 3: WI7ZZ (big blind) folded before Flop
Seat 4: kotlecior folded before Flop (didn't bet)
Seat 5: Zimniy collected ($0.25)
Seat 6: jump9922 folded before Flop (didn't bet)



PokerStars Zoom Hand #188747918856:  Hold'em No Limit ($0.05/$0.10) - 2018/07/15 13:18:08 WET [2018/07/15 8:18:08 ET]
Table 'Aludra' 6-max Seat #1 is the button
Seat 1: jump9922 ($10 in chips) 
Seat 2: ijkjgfq74 ($8.23 in chips) 
Seat 3: de1ty ($10 in chips) 
Seat 4: WI7ZZ ($16.37 in chips) 
Seat 5: gift-cloud9 ($11.38 in chips) 
Seat 6: icharliee ($14.68 in chips) 
ijkjgfq74: posts small blind $0.05
de1ty: posts big blind $0.10
*** HOLE CARDS ***
Dealt to WI7ZZ [3h Jd]
WI7ZZ: folds 
gift-cloud9: folds 
icharliee: folds 
jump9922: raises $0.15 to $0.25
ijkjgfq74: folds 
de1ty: calls $0.15
*** FLOP *** [Qd Ad Kh]
de1ty: checks 
jump9922: bets $0.35
de1ty: calls $0.35
*** TURN *** [Qd Ad Kh] [As]
de1ty: checks 
jump9922: checks 
*** RIVER *** [Qd Ad Kh As] [6d]
de1ty: bets $0.70
jump9922: folds 
Uncalled bet ($0.70) returned to de1ty
de1ty collected $1.19 from pot
de1ty: doesn't show hand 
*** SUMMARY ***
Total pot $1.25 | Rake $0.06 
Board [Qd Ad Kh As 6d]
Seat 1: jump9922 (button) folded on the River
Seat 2: ijkjgfq74 (small blind) folded before Flop
Seat 3: de1ty (big blind) collected ($1.19)
Seat 4: WI7ZZ folded before Flop (didn't bet)
Seat 5: gift-cloud9 folded before Flop (didn't bet)
Seat 6: icharliee folded before Flop (didn't bet)



PokerStars Zoom Hand #188747929377:  Hold'em No Limit ($0.05/$0.10) - 2018/07/15 13:18:31 WET [2018/07/15 8:18:31 ET]
Table 'Aludra' 6-max Seat #1 is the button
Seat 1: DobrikE.Al. ($10.03 in chips) 
Seat 2: WI7ZZ ($16.27 in chips) 
Seat 3: raisiden ($6.47 in chips) 
Seat 4: SuDDen1991 ($10 in chips) 
Seat 5: bubica0 ($47.71 in chips) 
Seat 6: Bet-3Bet-Push ($16.19 in chips) 
WI7ZZ: posts small blind $0.05
raisiden: posts big blind $0.10
*** HOLE CARDS ***
Dealt to WI7ZZ [8d 9d]
SuDDen1991: folds 
bubica0: folds 
Bet-3Bet-Push: folds 
DobrikE.Al.: folds 
WI7ZZ: raises $0.21 to $0.31
raisiden: calls $0.21
*** FLOP *** [3h Kh Tc]
WI7ZZ: bets $0.26
raisiden: calls $0.26
*** TURN *** [3h Kh Tc] [Ad]
WI7ZZ: checks 
raisiden: checks 
*** RIVER *** [3h Kh Tc Ad] [6d]
WI7ZZ: bets $0.48
raisiden: calls $0.48
*** SHOW DOWN ***
WI7ZZ: shows [8d 9d] (high card Ace)
raisiden: shows [9s 9h] (a pair of Nines)
raisiden collected $2.01 from pot
*** SUMMARY ***
Total pot $2.10 | Rake $0.09 
Board [3h Kh Tc Ad 6d]
Seat 1: DobrikE.Al. (button) folded before Flop (didn't bet)
Seat 2: WI7ZZ (small blind) showed [8d 9d] and lost with high card Ace
Seat 3: raisiden (big blind) showed [9s 9h] and won ($2.01) with a pair of Nines
Seat 4: SuDDen1991 folded before Flop (didn't bet)
Seat 5: bubica0 folded before Flop (didn't bet)
Seat 6: Bet-3Bet-Push folded before Flop (didn't bet)



PokerStars Zoom Hand #188747948281:  Hold'em No Limit ($0.05/$0.10) - 2018/07/15 13:19:12 WET [2018/07/15 8:19:12 ET]
Table 'Aludra' 6-max Seat #1 is the button
Seat 1: WI7ZZ ($15.22 in chips) 
Seat 2: LulaBluff ($5.34 in chips) 
Seat 3: Clear water,No ($9.85 in chips) 
Seat 4: IcePunishU ($10.05 in chips) 
Seat 5: Bolk udachi ($12.31 in chips) 
Seat 6: negreanuNya ($10.15 in chips) 
LulaBluff: posts small blind $0.05
Clear water,No: posts big blind $0.10
*** HOLE CARDS ***
Dealt to WI7ZZ [8s 4h]
IcePunishU: folds 
Bolk udachi: folds 
negreanuNya: raises $0.18 to $0.28
WI7ZZ: folds 
LulaBluff: folds 
Clear water,No: folds 
Uncalled bet ($0.18) returned to negreanuNya
negreanuNya collected $0.25 from pot
negreanuNya: doesn't show hand 
*** SUMMARY ***
Total pot $0.25 | Rake $0 
Seat 1: WI7ZZ (button) folded before Flop (didn't bet)
Seat 2: LulaBluff (small blind) folded before Flop
Seat 3: Clear water,No (big blind) folded before Flop
Seat 4: IcePunishU folded before Flop (didn't bet)
Seat 5: Bolk udachi folded before Flop (didn't bet)
Seat 6: negreanuNya collected ($0.25)



PokerStars Zoom Hand #188747950967:  Hold'em No Limit ($0.05/$0.10) - 2018/07/15 13:19:18 WET [2018/07/15 8:19:18 ET]
Table 'Aludra' 6-max Seat #1 is the button
Seat 1: klara1950 ($11.96 in chips) 
Seat 2: jump9922 ($11.74 in chips) 
Seat 3: TesTer23072911 ($10.38 in chips) 
Seat 4: KlausUwe91 ($7.86 in chips) 
Seat 5: WI7ZZ ($15.22 in chips) 
Seat 6: Dragonslyer1337 ($11.70 in chips) 
jump9922: posts small blind $0.05
TesTer23072911: posts big blind $0.10
*** HOLE CARDS ***
Dealt to WI7ZZ [Ac Js]
KlausUwe91: folds 
WI7ZZ: raises $0.21 to $0.31
Dragonslyer1337: folds 
klara1950: folds 
jump9922: folds 
TesTer23072911: folds 
Uncalled bet ($0.21) returned to WI7ZZ
WI7ZZ collected $0.25 from pot
WI7ZZ: doesn't show hand 
*** SUMMARY ***
Total pot $0.25 | Rake $0 
Seat 1: klara1950 (button) folded before Flop (didn't bet)
Seat 2: jump9922 (small blind) folded before Flop
Seat 3: TesTer23072911 (big blind) folded before Flop
Seat 4: KlausUwe91 folded before Flop (didn't bet)
Seat 5: WI7ZZ collected ($0.25)
Seat 6: Dragonslyer1337 folded before Flop (didn't bet)



PokerStars Zoom Hand #188747945426:  Hold'em No Limit ($0.05/$0.10) - 2018/07/15 13:19:06 WET [2018/07/15 8:19:06 ET]
Table 'Aludra' 6-max Seat #1 is the button
Seat 1: rack1777 ($16.02 in chips) 
Seat 2: raisiden ($7.43 in chips) 
Seat 3: 0201yuta ($15.10 in chips) 
Seat 4: jb112358 ($9.57 in chips) 
Seat 5: WI7ZZ ($15.22 in chips) 
Seat 6: LulaBluff ($5.34 in chips) 
raisiden: posts small blind $0.05
0201yuta: posts big blind $0.10
*** HOLE CARDS ***
Dealt to WI7ZZ [5h 8s]
jb112358: folds 
WI7ZZ: folds 
LulaBluff: folds 
rack1777: folds 
raisiden: raises $0.20 to $0.30
0201yuta: calls $0.20
*** FLOP *** [Ks 6s Kc]
raisiden: checks 
0201yuta: checks 
*** TURN *** [Ks 6s Kc] [2s]
raisiden: bets $0.29
0201yuta: calls $0.29
*** RIVER *** [Ks 6s Kc 2s] [4h]
raisiden: bets $0.57
0201yuta: calls $0.57
*** SHOW DOWN ***
raisiden: shows [Ac Ah] (two pair, Aces and Kings)
0201yuta: mucks hand 
raisiden collected $2.22 from pot
*** SUMMARY ***
Total pot $2.32 | Rake $0.10 
Board [Ks 6s Kc 2s 4h]
Seat 1: rack1777 (button) folded before Flop (didn't bet)
Seat 2: raisiden (small blind) showed [Ac Ah] and won ($2.22) with two pair, Aces and Kings
Seat 3: 0201yuta (big blind) mucked [3s 3h]
Seat 4: jb112358 folded before Flop (didn't bet)
Seat 5: WI7ZZ folded before Flop (didn't bet)
Seat 6: LulaBluff folded before Flop (didn't bet)



PokerStars Zoom Hand #188747949607:  Hold'em No Limit ($0.05/$0.10) - 2018/07/15 13:19:15 WET [2018/07/15 8:19:15 ET]
Table 'Aludra' 6-max Seat #1 is the button
Seat 1: KlassicBoxer ($10 in chips) 
Seat 2: Mukshinskijj ($15.91 in chips) 
Seat 3: tweeK1001 ($10.10 in chips) 
Seat 4: Lazy_dog[ru] ($10 in chips) 
Seat 5: indextown ($11.50 in chips) 
Seat 6: WI7ZZ ($15.22 in chips) 
Mukshinskijj: posts small blind $0.05
tweeK1001: posts big blind $0.10
*** HOLE CARDS ***
Dealt to WI7ZZ [Kc 7s]
Lazy_dog[ru]: raises $0.15 to $0.25
indextown: folds 
WI7ZZ: folds 
KlassicBoxer: folds 
Mukshinskijj: folds 
tweeK1001: raises $0.65 to $0.90
Lazy_dog[ru]: folds 
Uncalled bet ($0.65) returned to tweeK1001
tweeK1001 collected $0.55 from pot
tweeK1001: doesn't show hand 
*** SUMMARY ***
Total pot $0.55 | Rake $0 
Seat 1: KlassicBoxer (button) folded before Flop (didn't bet)
Seat 2: Mukshinskijj (small blind) folded before Flop
Seat 3: tweeK1001 (big blind) collected ($0.55)
Seat 4: Lazy_dog[ru] folded before Flop
Seat 5: indextown folded before Flop (didn't bet)
Seat 6: WI7ZZ folded before Flop (didn't bet)



PokerStars Zoom Hand #188747957867:  Hold'em No Limit ($0.05/$0.10) - 2018/07/15 13:19:33 WET [2018/07/15 8:19:33 ET]
Table 'Aludra' 6-max Seat #1 is the button
Seat 1: Foosball1980 ($14.46 in chips) 
Seat 2: Henryuan ($13.83 in chips) 
Seat 3: WI7ZZ ($15.37 in chips) 
Seat 4: Lily710 ($12.06 in chips) 
Seat 5: Day Day Up6 ($10.15 in chips) 
Seat 6: Andra.Andu ($10.53 in chips) 
Henryuan: posts small blind $0.05
WI7ZZ: posts big blind $0.10
*** HOLE CARDS ***
Dealt to WI7ZZ [9d 4d]
Lily710: folds 
Day Day Up6: folds 
Andra.Andu: folds 
Foosball1980: raises $0.12 to $0.22
Henryuan: folds 
WI7ZZ: folds 
Uncalled bet ($0.12) returned to Foosball1980
Foosball1980 collected $0.25 from pot
Foosball1980: doesn't show hand 
*** SUMMARY ***
Total pot $0.25 | Rake $0 
Seat 1: Foosball1980 (button) collected ($0.25)
Seat 2: Henryuan (small blind) folded before Flop
Seat 3: WI7ZZ (big blind) folded before Flop
Seat 4: Lily710 folded before Flop (didn't bet)
Seat 5: Day Day Up6 folded before Flop (didn't bet)
Seat 6: Andra.Andu folded before Flop (didn't bet)



PokerStars Zoom Hand #188747946889:  Hold'em No Limit ($0.05/$0.10) - 2018/07/15 13:19:09 WET [2018/07/15 8:19:09 ET]
Table 'Aludra' 6-max Seat #1 is the button
Seat 1: mir0417 ($24.36 in chips) 
Seat 2: SKD TEAM PRO ($12.16 in chips) 
Seat 3: naglugalva ($7.97 in chips) 
Seat 4: WI7ZZ ($15.22 in chips) 
Seat 5: KlassicBoxer ($10.15 in chips) 
Seat 6: Clear water,No ($10 in chips) 
SKD TEAM PRO: posts small blind $0.05
naglugalva: posts big blind $0.10
*** HOLE CARDS ***
Dealt to WI7ZZ [7d Ac]
WI7ZZ: folds 
KlassicBoxer: raises $0.15 to $0.25
Clear water,No: folds 
mir0417: folds 
SKD TEAM PRO: folds 
naglugalva: calls $0.15
*** FLOP *** [5s 7s Qh]
naglugalva: checks 
KlassicBoxer: bets $0.17
naglugalva: calls $0.17
*** TURN *** [5s 7s Qh] [2d]
naglugalva: checks 
KlassicBoxer: bets $0.56
naglugalva: calls $0.56
*** RIVER *** [5s 7s Qh 2d] [4h]
naglugalva: checks 
KlassicBoxer: bets $1.44
naglugalva: folds 
Uncalled bet ($1.44) returned to KlassicBoxer
KlassicBoxer collected $1.92 from pot
KlassicBoxer: doesn't show hand 
*** SUMMARY ***
Total pot $2.01 | Rake $0.09 
Board [5s 7s Qh 2d 4h]
Seat 1: mir0417 (button) folded before Flop (didn't bet)
Seat 2: SKD TEAM PRO (small blind) folded before Flop
Seat 3: naglugalva (big blind) folded on the River
Seat 4: WI7ZZ folded before Flop (didn't bet)
Seat 5: KlassicBoxer collected ($1.92)
Seat 6: Clear water,No folded before Flop (didn't bet)



PokerStars Zoom Hand #188747967496:  Hold'em No Limit ($0.05/$0.10) - 2018/07/15 13:19:54 WET [2018/07/15 8:19:54 ET]
Table 'Aludra' 6-max Seat #1 is the button
Seat 1: WI7ZZ ($15.22 in chips) 
Seat 2: filifera ($7.85 in chips) 
Seat 3: MACAY_33 ($18.18 in chips) 
Seat 4: THE DOG#9 ($14.26 in chips) 
Seat 5: Mukshinskijj ($15.76 in chips) 
Seat 6: fish2427 ($9.95 in chips) 
filifera: posts small blind $0.05
MACAY_33: posts big blind $0.10
*** HOLE CARDS ***
Dealt to WI7ZZ [5d 3h]
THE DOG#9: folds 
Mukshinskijj: folds 
fish2427: folds 
WI7ZZ: folds 
filifera: folds 
Uncalled bet ($0.05) returned to MACAY_33
MACAY_33 collected $0.10 from pot
MACAY_33: doesn't show hand 
*** SUMMARY ***
Total pot $0.10 | Rake $0 
Seat 1: WI7ZZ (button) folded before Flop (didn't bet)
Seat 2: filifera (small blind) folded before Flop
Seat 3: MACAY_33 (big blind) collected ($0.10)
Seat 4: THE DOG#9 folded before Flop (didn't bet)
Seat 5: Mukshinskijj folded before Flop (didn't bet)
Seat 6: fish2427 folded before Flop (didn't bet)



PokerStars Zoom Hand #188747969301:  Hold'em No Limit ($0.05/$0.10) - 2018/07/15 13:19:58 WET [2018/07/15 8:19:58 ET]
Table 'Aludra' 6-max Seat #1 is the button
Seat 1: Jarness II ($10.30 in chips) 
Seat 2: negreanuNya ($10.35 in chips) 
Seat 3: Blonskiy ($10 in chips) 
Seat 4: WI7ZZ ($15.22 in chips) 
Seat 5: kotlecior ($11.19 in chips) 
Seat 6: jb112358 ($11.20 in chips) 
negreanuNya: posts small blind $0.05
Blonskiy: posts big blind $0.10
*** HOLE CARDS ***
Dealt to WI7ZZ [9h Js]
WI7ZZ: folds 
kotlecior: folds 
jb112358: folds 
Jarness II: folds 
negreanuNya: folds 
Uncalled bet ($0.05) returned to Blonskiy
Blonskiy collected $0.10 from pot
Blonskiy: doesn't show hand 
*** SUMMARY ***
Total pot $0.10 | Rake $0 
Seat 1: Jarness II (button) folded before Flop (didn't bet)
Seat 2: negreanuNya (small blind) folded before Flop
Seat 3: Blonskiy (big blind) collected ($0.10)
Seat 4: WI7ZZ folded before Flop (didn't bet)
Seat 5: kotlecior folded before Flop (didn't bet)
Seat 6: jb112358 folded before Flop (didn't bet)



PokerStars Zoom Hand #188747964694:  Hold'em No Limit ($0.05/$0.10) - 2018/07/15 13:19:48 WET [2018/07/15 8:19:48 ET]
Table 'Aludra' 6-max Seat #1 is the button
Seat 1: Sheremetov88 ($19.62 in chips) 
Seat 2: WI7ZZ ($15.27 in chips) 
Seat 3: AK_lucky_AK ($10 in chips) 
Seat 4: filifera ($7.85 in chips) 
Seat 5: marian10049 ($7.05 in chips) 
Seat 6: Lazy_dog[ru] ($10 in chips) 
WI7ZZ: posts small blind $0.05
AK_lucky_AK: posts big blind $0.10
*** HOLE CARDS ***
Dealt to WI7ZZ [3h Qd]
filifera: folds 
marian10049: raises $0.10 to $0.20
Lazy_dog[ru]: folds 
Sheremetov88: calls $0.20
WI7ZZ: folds 
AK_lucky_AK: folds 
*** FLOP *** [4h Tc As]
marian10049: checks 
Sheremetov88: checks 
*** TURN *** [4h Tc As] [6d]
marian10049: bets $0.10
Sheremetov88: raises $0.37 to $0.47
marian10049: folds 
Uncalled bet ($0.37) returned to Sheremetov88
Sheremetov88 collected $0.72 from pot
Sheremetov88: doesn't show hand 
*** SUMMARY ***
Total pot $0.75 | Rake $0.03 
Board [4h Tc As 6d]
Seat 1: Sheremetov88 (button) collected ($0.72)
Seat 2: WI7ZZ (small blind) folded before Flop
Seat 3: AK_lucky_AK (big blind) folded before Flop
Seat 4: filifera folded before Flop (didn't bet)
Seat 5: marian10049 folded on the Turn
Seat 6: Lazy_dog[ru] folded before Flop (didn't bet)



PokerStars Zoom Hand #188747966075:  Hold'em No Limit ($0.05/$0.10) - 2018/07/15 13:19:51 WET [2018/07/15 8:19:51 ET]
Table 'Aludra' 6-max Seat #1 is the button
Seat 1: Gevron ($24.79 in chips) 
Seat 2: Spooks1337 ($26.58 in chips) 
Seat 3: Vespao20 ($10 in chips) 
Seat 4: Toxa512 ($10.63 in chips) 
Seat 5: San4eZzz77 ($9.85 in chips) 
Seat 6: WI7ZZ ($15.22 in chips) 
Spooks1337: posts small blind $0.05
Vespao20: posts big blind $0.10
*** HOLE CARDS ***
Dealt to WI7ZZ [2d Qs]
Toxa512: folds 
San4eZzz77: folds 
WI7ZZ: folds 
Gevron: raises $0.10 to $0.20
Spooks1337: calls $0.15
Vespao20: folds 
*** FLOP *** [Qh 6s Td]
Spooks1337: checks 
Gevron: bets $0.24
Spooks1337: folds 
Uncalled bet ($0.24) returned to Gevron
Gevron collected $0.48 from pot
Gevron: doesn't show hand 
*** SUMMARY ***
Total pot $0.50 | Rake $0.02 
Board [Qh 6s Td]
Seat 1: Gevron (button) collected ($0.48)
Seat 2: Spooks1337 (small blind) folded on the Flop
Seat 3: Vespao20 (big blind) folded before Flop
Seat 4: Toxa512 folded before Flop (didn't bet)
Seat 5: San4eZzz77 folded before Flop (didn't bet)
Seat 6: WI7ZZ folded before Flop (didn't bet)



PokerStars Zoom Hand #188747970711:  Hold'em No Limit ($0.05/$0.10) - 2018/07/15 13:20:01 WET [2018/07/15 8:20:01 ET]
Table 'Aludra' 6-max Seat #1 is the button
Seat 1: pushi2 ($12.02 in chips) 
Seat 2: XXschmidtX ($15.42 in chips) 
Seat 3: Diamond-PL ($13.34 in chips) 
Seat 4: WI7ZZ ($15.22 in chips) 
Seat 5: tweeK1001 ($10.55 in chips) 
Seat 6: illuvatar125 ($10.23 in chips) 
XXschmidtX: posts small blind $0.05
Diamond-PL: posts big blind $0.10
*** HOLE CARDS ***
Dealt to WI7ZZ [Ac 9d]
WI7ZZ: folds 
tweeK1001: raises $0.15 to $0.25
illuvatar125: folds 
pushi2: folds 
XXschmidtX: folds 
Diamond-PL: calls $0.15
*** FLOP *** [4c 6s Ad]
Diamond-PL: checks 
tweeK1001: bets $0.27
Diamond-PL: folds 
Uncalled bet ($0.27) returned to tweeK1001
tweeK1001 collected $0.53 from pot
tweeK1001: doesn't show hand 
*** SUMMARY ***
Total pot $0.55 | Rake $0.02 
Board [4c 6s Ad]
Seat 1: pushi2 (button) folded before Flop (didn't bet)
Seat 2: XXschmidtX (small blind) folded before Flop
Seat 3: Diamond-PL (big blind) folded on the Flop
Seat 4: WI7ZZ folded before Flop (didn't bet)
Seat 5: tweeK1001 collected ($0.53)
Seat 6: illuvatar125 folded before Flop (didn't bet)



PokerStars Zoom Hand #188747973931:  Hold'em No Limit ($0.05/$0.10) - 2018/07/15 13:20:08 WET [2018/07/15 8:20:08 ET]
Table 'Aludra' 6-max Seat #1 is the button
Seat 1: kotlecior ($10.10 in chips) 
Seat 2: vkartmann ($12.80 in chips) 
Seat 3: WI7ZZ ($15.22 in chips) 
Seat 4: MOU77Y ($13.31 in chips) 
Seat 5: QuakieMan ($12.49 in chips) 
Seat 6: ultra radi ($13.76 in chips) 
vkartmann: posts small blind $0.05
WI7ZZ: posts big blind $0.10
*** HOLE CARDS ***
Dealt to WI7ZZ [2d 2h]
MOU77Y: folds 
QuakieMan: raises $0.20 to $0.30
ultra radi: calls $0.30
kotlecior: folds 
vkartmann: raises $1.45 to $1.75
WI7ZZ: folds 
QuakieMan: folds 
ultra radi: calls $1.45
*** FLOP *** [Jh 4h Th]
vkartmann: checks 
ultra radi: checks 
*** TURN *** [Jh 4h Th] [Qs]
vkartmann: checks 
ultra radi: checks 
*** RIVER *** [Jh 4h Th Qs] [Ad]
vkartmann: bets $2.45
ultra radi: folds 
Uncalled bet ($2.45) returned to vkartmann
vkartmann collected $3.72 from pot
vkartmann: doesn't show hand 
*** SUMMARY ***
Total pot $3.90 | Rake $0.18 
Board [Jh 4h Th Qs Ad]
Seat 1: kotlecior (button) folded before Flop (didn't bet)
Seat 2: vkartmann (small blind) collected ($3.72)
Seat 3: WI7ZZ (big blind) folded before Flop
Seat 4: MOU77Y folded before Flop (didn't bet)
Seat 5: QuakieMan folded before Flop
Seat 6: ultra radi folded on the River



PokerStars Zoom Hand #188747972093:  Hold'em No Limit ($0.05/$0.10) - 2018/07/15 13:20:04 WET [2018/07/15 8:20:04 ET]
Table 'Aludra' 6-max Seat #1 is the button
Seat 1: VAHRAMASHEN ($10 in chips) 
Seat 2: bradm195 ($24.36 in chips) 
Seat 3: Rude8oy9 ($21.97 in chips) 
Seat 4: TITEUF-BE ($11.70 in chips) 
Seat 5: AK_lucky_AK ($10 in chips) 
Seat 6: WI7ZZ ($15.22 in chips) 
bradm195: posts small blind $0.05
Rude8oy9: posts big blind $0.10
*** HOLE CARDS ***
Dealt to WI7ZZ [5s 8c]
TITEUF-BE: folds 
AK_lucky_AK: folds 
WI7ZZ: folds 
VAHRAMASHEN: raises $0.14 to $0.24
bradm195: folds 
Rude8oy9: calls $0.14
*** FLOP *** [Ts 2c 9s]
Rude8oy9: checks 
VAHRAMASHEN: bets $0.40
Rude8oy9: calls $0.40
*** TURN *** [Ts 2c 9s] [Td]
Rude8oy9: checks 
VAHRAMASHEN: checks 
*** RIVER *** [Ts 2c 9s Td] [7h]
Rude8oy9: checks 
VAHRAMASHEN: checks 
*** SHOW DOWN ***
Rude8oy9: shows [As 8s] (a pair of Tens)
VAHRAMASHEN: shows [9h Kh] (two pair, Tens and Nines)
VAHRAMASHEN collected $1.27 from pot
*** SUMMARY ***
Total pot $1.33 | Rake $0.06 
Board [Ts 2c 9s Td 7h]
Seat 1: VAHRAMASHEN (button) showed [9h Kh] and won ($1.27) with two pair, Tens and Nines
Seat 2: bradm195 (small blind) folded before Flop
Seat 3: Rude8oy9 (big blind) showed [As 8s] and lost with a pair of Tens
Seat 4: TITEUF-BE folded before Flop (didn't bet)
Seat 5: AK_lucky_AK folded before Flop (didn't bet)
Seat 6: WI7ZZ folded before Flop (didn't bet)



PokerStars Zoom Hand #188747990903:  Hold'em No Limit ($0.05/$0.10) - 2018/07/15 13:20:45 WET [2018/07/15 8:20:45 ET]
Table 'Aludra' 6-max Seat #1 is the button
Seat 1: tweeK1001 ($11.33 in chips) 
Seat 2: WI7ZZ ($15.12 in chips) 
Seat 3: Sheremetov88 ($14.31 in chips) 
Seat 4: negreanuNya ($10.35 in chips) 
Seat 5: JohnnyRico91 ($15.59 in chips) 
Seat 6: nikitos88887 ($15.39 in chips) 
WI7ZZ: posts small blind $0.05
Sheremetov88: posts big blind $0.10
*** HOLE CARDS ***
Dealt to WI7ZZ [8h 9h]
negreanuNya: folds 
JohnnyRico91: raises $0.10 to $0.20
nikitos88887: calls $0.20
tweeK1001: folds 
WI7ZZ: calls $0.15
Sheremetov88: folds 
*** FLOP *** [3c 7d 7h]
WI7ZZ: bets $0.29
JohnnyRico91: folds 
nikitos88887: folds 
Uncalled bet ($0.29) returned to WI7ZZ
WI7ZZ collected $0.67 from pot
WI7ZZ: doesn't show hand 
*** SUMMARY ***
Total pot $0.70 | Rake $0.03 
Board [3c 7d 7h]
Seat 1: tweeK1001 (button) folded before Flop (didn't bet)
Seat 2: WI7ZZ (small blind) collected ($0.67)
Seat 3: Sheremetov88 (big blind) folded before Flop
Seat 4: negreanuNya folded before Flop (didn't bet)
Seat 5: JohnnyRico91 folded on the Flop
Seat 6: nikitos88887 folded on the Flop



PokerStars Zoom Hand #188748009329:  Hold'em No Limit ($0.05/$0.10) - 2018/07/15 13:21:25 WET [2018/07/15 8:21:25 ET]
Table 'Aludra' 6-max Seat #1 is the button
Seat 1: TestaDiCazz ($10.05 in chips) 
Seat 2: FULLFREEDOM ($3.80 in chips) 
Seat 3: Bet-3Bet-Push ($17.07 in chips) 
Seat 4: denikin05 ($10.78 in chips) 
Seat 5: WI7ZZ ($15.59 in chips) 
Seat 6: anthony1480 ($5.35 in chips) 
FULLFREEDOM: posts small blind $0.05
Bet-3Bet-Push: posts big blind $0.10
*** HOLE CARDS ***
Dealt to WI7ZZ [4s 5s]
denikin05: folds 
WI7ZZ: folds 
anthony1480: folds 
TestaDiCazz: folds 
FULLFREEDOM: folds 
Uncalled bet ($0.05) returned to Bet-3Bet-Push
Bet-3Bet-Push collected $0.10 from pot
Bet-3Bet-Push: doesn't show hand 
*** SUMMARY ***
Total pot $0.10 | Rake $0 
Seat 1: TestaDiCazz (button) folded before Flop (didn't bet)
Seat 2: FULLFREEDOM (small blind) folded before Flop
Seat 3: Bet-3Bet-Push (big blind) collected ($0.10)
Seat 4: denikin05 folded before Flop (didn't bet)
Seat 5: WI7ZZ folded before Flop (didn't bet)
Seat 6: anthony1480 folded before Flop (didn't bet)



PokerStars Zoom Hand #188748007068:  Hold'em No Limit ($0.05/$0.10) - 2018/07/15 13:21:20 WET [2018/07/15 8:21:20 ET]
Table 'Aludra' 6-max Seat #1 is the button
Seat 1: kamikaza11 ($11.18 in chips) 
Seat 2: drunya1968 ($17.96 in chips) 
Seat 3: San4eZzz77 ($15.57 in chips) 
Seat 4: IcePunishU ($10.96 in chips) 
Seat 5: WI7ZZ ($15.59 in chips) 
Seat 6: naposim1991 ($10.31 in chips) 
drunya1968: posts small blind $0.05
San4eZzz77: posts big blind $0.10
*** HOLE CARDS ***
Dealt to WI7ZZ [Kd 4h]
IcePunishU: folds 
WI7ZZ: folds 
naposim1991: raises $0.10 to $0.20
kamikaza11: folds 
drunya1968: folds 
San4eZzz77: folds 
Uncalled bet ($0.10) returned to naposim1991
naposim1991 collected $0.25 from pot
naposim1991: doesn't show hand 
*** SUMMARY ***
Total pot $0.25 | Rake $0 
Seat 1: kamikaza11 (button) folded before Flop (didn't bet)
Seat 2: drunya1968 (small blind) folded before Flop
Seat 3: San4eZzz77 (big blind) folded before Flop
Seat 4: IcePunishU folded before Flop (didn't bet)
Seat 5: WI7ZZ folded before Flop (didn't bet)
Seat 6: naposim1991 collected ($0.25)



PokerStars Zoom Hand #188748010244:  Hold'em No Limit ($0.05/$0.10) - 2018/07/15 13:21:27 WET [2018/07/15 8:21:27 ET]
Table 'Aludra' 6-max Seat #1 is the button
Seat 1: Trembon ($6.66 in chips) 
Seat 2: WI7ZZ ($15.59 in chips) 
Seat 3: Sheremetov88 ($20.19 in chips) 
Seat 4: pushi2 ($11.15 in chips) 
Seat 5: 0201yuta ($11.58 in chips) 
Seat 6: bubica0 ($5.29 in chips) 
WI7ZZ: posts small blind $0.05
Sheremetov88: posts big blind $0.10
*** HOLE CARDS ***
Dealt to WI7ZZ [9d Qd]
pushi2: folds 
0201yuta: folds 
bubica0: raises $0.15 to $0.25
Trembon: folds 
WI7ZZ: calls $0.20
Sheremetov88: folds 
*** FLOP *** [Ts 4s 5d]
WI7ZZ: checks 
bubica0: bets $0.28
WI7ZZ: folds 
Uncalled bet ($0.28) returned to bubica0
bubica0 collected $0.57 from pot
*** SUMMARY ***
Total pot $0.60 | Rake $0.03 
Board [Ts 4s 5d]
Seat 1: Trembon (button) folded before Flop (didn't bet)
Seat 2: WI7ZZ (small blind) folded on the Flop
Seat 3: Sheremetov88 (big blind) folded before Flop
Seat 4: pushi2 folded before Flop (didn't bet)
Seat 5: 0201yuta folded before Flop (didn't bet)
Seat 6: bubica0 collected ($0.57)



PokerStars Zoom Hand #188748008452:  Hold'em No Limit ($0.05/$0.10) - 2018/07/15 13:21:23 WET [2018/07/15 8:21:23 ET]
Table 'Aludra' 6-max Seat #1 is the button
Seat 1: WI7ZZ ($15.59 in chips) 
Seat 2: Sea Bas123 ($4.85 in chips) 
Seat 3: ChungkingExp ($20.49 in chips) 
Seat 4: nikitos88887 ($15.19 in chips) 
Seat 5: Snowplack ($23.55 in chips) 
Seat 6: anakinn888 ($8.58 in chips) 
Sea Bas123: posts small blind $0.05
ChungkingExp: posts big blind $0.10
*** HOLE CARDS ***
Dealt to WI7ZZ [3h Tc]
nikitos88887: raises $0.10 to $0.20
Snowplack: folds 
anakinn888: folds 
WI7ZZ: folds 
Sea Bas123: folds 
ChungkingExp: calls $0.10
*** FLOP *** [6s 9s 7c]
ChungkingExp: checks 
nikitos88887: bets $0.22
ChungkingExp: raises $0.57 to $0.79
nikitos88887: calls $0.57
*** TURN *** [6s 9s 7c] [Th]
ChungkingExp: checks 
nikitos88887: checks 
*** RIVER *** [6s 9s 7c Th] [4s]
ChungkingExp: checks 
nikitos88887: checks 
*** SHOW DOWN ***
ChungkingExp: shows [Js 8s] (a flush, Jack high)
nikitos88887: mucks hand 
ChungkingExp collected $1.94 from pot
*** SUMMARY ***
Total pot $2.03 | Rake $0.09 
Board [6s 9s 7c Th 4s]
Seat 1: WI7ZZ (button) folded before Flop (didn't bet)
Seat 2: Sea Bas123 (small blind) folded before Flop
Seat 3: ChungkingExp (big blind) showed [Js 8s] and won ($1.94) with a flush, Jack high
Seat 4: nikitos88887 mucked [Qs Qc]
Seat 5: Snowplack folded before Flop (didn't bet)
Seat 6: anakinn888 folded before Flop (didn't bet)



PokerStars Zoom Hand #188748019476:  Hold'em No Limit ($0.05/$0.10) - 2018/07/15 13:21:47 WET [2018/07/15 8:21:47 ET]
Table 'Aludra' 6-max Seat #1 is the button
Seat 1: raf9505 ($10.15 in chips) 
Seat 2: Only_Vizard ($19.67 in chips) 
Seat 3: SKD TEAM PRO ($12.07 in chips) 
Seat 4: kotlecior ($19.95 in chips) 
Seat 5: CojocaruSV ($10.28 in chips) 
Seat 6: WI7ZZ ($15.34 in chips) 
Only_Vizard: posts small blind $0.05
SKD TEAM PRO: posts big blind $0.10
*** HOLE CARDS ***
Dealt to WI7ZZ [Ac 3d]
kotlecior: folds 
CojocaruSV: folds 
WI7ZZ: raises $0.16 to $0.26
raf9505: folds 
Only_Vizard: folds 
SKD TEAM PRO: calls $0.16
*** FLOP *** [9s 2h 6d]
SKD TEAM PRO: checks 
WI7ZZ: checks 
*** TURN *** [9s 2h 6d] [2s]
SKD TEAM PRO: checks 
WI7ZZ: bets $0.24
SKD TEAM PRO: calls $0.24
*** RIVER *** [9s 2h 6d 2s] [7h]
SKD TEAM PRO: checks 
WI7ZZ: checks 
*** SHOW DOWN ***
SKD TEAM PRO: shows [5s 5h] (two pair, Fives and Deuces)
WI7ZZ: mucks hand 
SKD TEAM PRO collected $1 from pot
*** SUMMARY ***
Total pot $1.05 | Rake $0.05 
Board [9s 2h 6d 2s 7h]
Seat 1: raf9505 (button) folded before Flop (didn't bet)
Seat 2: Only_Vizard (small blind) folded before Flop
Seat 3: SKD TEAM PRO (big blind) showed [5s 5h] and won ($1) with two pair, Fives and Deuces
Seat 4: kotlecior folded before Flop (didn't bet)
Seat 5: CojocaruSV folded before Flop (didn't bet)
Seat 6: WI7ZZ mucked [Ac 3d]



PokerStars Zoom Hand #188748039139:  Hold'em No Limit ($0.05/$0.10) - 2018/07/15 13:22:30 WET [2018/07/15 8:22:30 ET]
Table 'Aludra' 6-max Seat #1 is the button
Seat 1: sTIKs21 ($13.26 in chips) 
Seat 2: SKD TEAM PRO ($12.57 in chips) 
Seat 3: WI7ZZ ($14.84 in chips) 
Seat 4: littbar ($11.51 in chips) 
Seat 5: KeySssi ($14.29 in chips) 
Seat 6: Dragonslyer1337 ($13.34 in chips) 
SKD TEAM PRO: posts small blind $0.05
WI7ZZ: posts big blind $0.10
*** HOLE CARDS ***
Dealt to WI7ZZ [5s 6d]
littbar: folds 
KeySssi: folds 
Dragonslyer1337: folds 
sTIKs21: folds 
SKD TEAM PRO: folds 
Uncalled bet ($0.05) returned to WI7ZZ
WI7ZZ collected $0.10 from pot
WI7ZZ: doesn't show hand 
*** SUMMARY ***
Total pot $0.10 | Rake $0 
Seat 1: sTIKs21 (button) folded before Flop (didn't bet)
Seat 2: SKD TEAM PRO (small blind) folded before Flop
Seat 3: WI7ZZ (big blind) collected ($0.10)
Seat 4: littbar folded before Flop (didn't bet)
Seat 5: KeySssi folded before Flop (didn't bet)
Seat 6: Dragonslyer1337 folded before Flop (didn't bet)



PokerStars Zoom Hand #188748047690:  Hold'em No Limit ($0.05/$0.10) - 2018/07/15 13:22:49 WET [2018/07/15 8:22:49 ET]
Table 'Aludra' 6-max Seat #1 is the button
Seat 1: PEE0202 ($17.68 in chips) 
Seat 2: littbar ($19.42 in chips) 
Seat 3: chadrawn ($8.70 in chips) 
Seat 4: Clear water,No ($9.95 in chips) 
Seat 5: jb112358 ($9.95 in chips) 
Seat 6: WI7ZZ ($14.89 in chips) 
littbar: posts small blind $0.05
chadrawn: posts big blind $0.10
*** HOLE CARDS ***
Dealt to WI7ZZ [6c As]
Clear water,No: folds 
jb112358: folds 
WI7ZZ: folds 
PEE0202: raises $0.25 to $0.35
littbar: folds 
chadrawn: folds 
Uncalled bet ($0.25) returned to PEE0202
PEE0202 collected $0.25 from pot
PEE0202: doesn't show hand 
*** SUMMARY ***
Total pot $0.25 | Rake $0 
Seat 1: PEE0202 (button) collected ($0.25)
Seat 2: littbar (small blind) folded before Flop
Seat 3: chadrawn (big blind) folded before Flop
Seat 4: Clear water,No folded before Flop (didn't bet)
Seat 5: jb112358 folded before Flop (didn't bet)
Seat 6: WI7ZZ folded before Flop (didn't bet)



PokerStars Zoom Hand #188748044569:  Hold'em No Limit ($0.05/$0.10) - 2018/07/15 13:22:42 WET [2018/07/15 8:22:42 ET]
Table 'Aludra' 6-max Seat #1 is the button
Seat 1: WI7ZZ ($14.89 in chips) 
Seat 2: kotlecior ($10.39 in chips) 
Seat 3: IntGo ($8.40 in chips) 
Seat 4: PleyaDeanS ($24.12 in chips) 
Seat 5: bubica0 ($7.91 in chips) 
Seat 6: agardner ($10 in chips) 
kotlecior: posts small blind $0.05
IntGo: posts big blind $0.10
*** HOLE CARDS ***
Dealt to WI7ZZ [4s 2d]
PleyaDeanS: folds 
bubica0: raises $0.15 to $0.25
agardner: raises $0.45 to $0.70
WI7ZZ: folds 
kotlecior: folds 
IntGo: folds 
bubica0: folds 
Uncalled bet ($0.45) returned to agardner
agardner collected $0.65 from pot
agardner: doesn't show hand 
*** SUMMARY ***
Total pot $0.65 | Rake $0 
Seat 1: WI7ZZ (button) folded before Flop (didn't bet)
Seat 2: kotlecior (small blind) folded before Flop
Seat 3: IntGo (big blind) folded before Flop
Seat 4: PleyaDeanS folded before Flop (didn't bet)
Seat 5: bubica0 folded before Flop
Seat 6: agardner collected ($0.65)



PokerStars Zoom Hand #188748049579:  Hold'em No Limit ($0.05/$0.10) - 2018/07/15 13:22:53 WET [2018/07/15 8:22:53 ET]
Table 'Aludra' 6-max Seat #1 is the button
Seat 1: zvyaga1985 ($5.13 in chips) 
Seat 2: Toxa512 ($13.07 in chips) 
Seat 3: WI7ZZ ($14.89 in chips) 
Seat 4: Juurikas ($12.21 in chips) 
Seat 5: -=l Grek l=- ($32.29 in chips) 
Seat 6: wwfzfjiv ($17.92 in chips) 
Toxa512: posts small blind $0.05
WI7ZZ: posts big blind $0.10
*** HOLE CARDS ***
Dealt to WI7ZZ [Td 7h]
Juurikas: folds 
-=l Grek l=-: folds 
wwfzfjiv: folds 
zvyaga1985: calls $0.10
Toxa512: folds 
WI7ZZ: checks 
*** FLOP *** [4d 3c 6s]
WI7ZZ: bets $0.11
zvyaga1985: calls $0.11
*** TURN *** [4d 3c 6s] [9c]
WI7ZZ: bets $0.20
zvyaga1985: calls $0.20
*** RIVER *** [4d 3c 6s 9c] [Jd]
WI7ZZ: checks 
zvyaga1985: bets $0.42
WI7ZZ: folds 
Uncalled bet ($0.42) returned to zvyaga1985
zvyaga1985 collected $0.83 from pot
*** SUMMARY ***
Total pot $0.87 | Rake $0.04 
Board [4d 3c 6s 9c Jd]
Seat 1: zvyaga1985 (button) collected ($0.83)
Seat 2: Toxa512 (small blind) folded before Flop
Seat 3: WI7ZZ (big blind) folded on the River
Seat 4: Juurikas folded before Flop (didn't bet)
Seat 5: -=l Grek l=- folded before Flop (didn't bet)
Seat 6: wwfzfjiv folded before Flop (didn't bet)



PokerStars Zoom Hand #188748977255:  Hold'em No Limit ($0.05/$0.10) - 2018/07/15 13:55:38 WET [2018/07/15 8:55:38 ET]
Table 'Aludra' 6-max Seat #1 is the button
Seat 1: ssvensson666 ($7.25 in chips) 
Seat 2: vacvan ($10.40 in chips) 
Seat 3: WI7ZZ ($10 in chips) 
Seat 4: Blackdrago93 ($14.60 in chips) 
Seat 5: APavlychev ($10.05 in chips) 
Seat 6: KlassicBoxer ($16.52 in chips) 
vacvan: posts small blind $0.05
WI7ZZ: posts big blind $0.10
*** HOLE CARDS ***
Dealt to WI7ZZ [4d Jh]
Blackdrago93: folds 
APavlychev: folds 
KlassicBoxer: folds 
ssvensson666: raises $0.20 to $0.30
vacvan: folds 
WI7ZZ: folds 
Uncalled bet ($0.20) returned to ssvensson666
ssvensson666 collected $0.25 from pot
*** SUMMARY ***
Total pot $0.25 | Rake $0 
Seat 1: ssvensson666 (button) collected ($0.25)
Seat 2: vacvan (small blind) folded before Flop
Seat 3: WI7ZZ (big blind) folded before Flop
Seat 4: Blackdrago93 folded before Flop (didn't bet)
Seat 5: APavlychev folded before Flop (didn't bet)
Seat 6: KlassicBoxer folded before Flop (didn't bet)



PokerStars Zoom Hand #188748982570:  Hold'em No Limit ($0.05/$0.10) - 2018/07/15 13:55:51 WET [2018/07/15 8:55:51 ET]
Table 'Aludra' 6-max Seat #1 is the button
Seat 1: hiromasa167 ($8.06 in chips) 
Seat 2: WI7ZZ ($9.90 in chips) 
Seat 3: Juurikas ($10 in chips) 
Seat 4: sTIKs21 ($16.67 in chips) 
Seat 5: johnkanon13 ($22.48 in chips) 
Seat 6: Andra.Andu ($11.83 in chips) 
WI7ZZ: posts small blind $0.05
Juurikas: posts big blind $0.10
*** HOLE CARDS ***
Dealt to WI7ZZ [Th 3h]
sTIKs21: folds 
johnkanon13: folds 
Andra.Andu: folds 
hiromasa167: folds 
WI7ZZ: folds 
Uncalled bet ($0.05) returned to Juurikas
Juurikas collected $0.10 from pot
Juurikas: doesn't show hand 
*** SUMMARY ***
Total pot $0.10 | Rake $0 
Seat 1: hiromasa167 (button) folded before Flop (didn't bet)
Seat 2: WI7ZZ (small blind) folded before Flop
Seat 3: Juurikas (big blind) collected ($0.10)
Seat 4: sTIKs21 folded before Flop (didn't bet)
Seat 5: johnkanon13 folded before Flop (didn't bet)
Seat 6: Andra.Andu folded before Flop (didn't bet)



PokerStars Zoom Hand #188748986721:  Hold'em No Limit ($0.05/$0.10) - 2018/07/15 13:56:01 WET [2018/07/15 8:56:01 ET]
Table 'Aludra' 6-max Seat #1 is the button
Seat 1: Jinxers ($15.98 in chips) 
Seat 2: tiodor1972 ($10 in chips) 
Seat 3: Clear water,No ($11.11 in chips) 
Seat 4: sylwesterrr ($8.38 in chips) 
Seat 5: TestaDiCazz ($10 in chips) 
Seat 6: WI7ZZ ($9.85 in chips) 
tiodor1972: posts small blind $0.05
Clear water,No: posts big blind $0.10
*** HOLE CARDS ***
Dealt to WI7ZZ [6h Qh]
sylwesterrr: folds 
TestaDiCazz: folds 
WI7ZZ: folds 
Jinxers: folds 
tiodor1972: folds 
Uncalled bet ($0.05) returned to Clear water,No
Clear water,No collected $0.10 from pot
Clear water,No: doesn't show hand 
*** SUMMARY ***
Total pot $0.10 | Rake $0 
Seat 1: Jinxers (button) folded before Flop (didn't bet)
Seat 2: tiodor1972 (small blind) folded before Flop
Seat 3: Clear water,No (big blind) collected ($0.10)
Seat 4: sylwesterrr folded before Flop (didn't bet)
Seat 5: TestaDiCazz folded before Flop (didn't bet)
Seat 6: WI7ZZ folded before Flop (didn't bet)



PokerStars Zoom Hand #188748988778:  Hold'em No Limit ($0.05/$0.10) - 2018/07/15 13:56:06 WET [2018/07/15 8:56:06 ET]
Table 'Aludra' 6-max Seat #1 is the button
Seat 1: 1_gaborik ($14.79 in chips) 
Seat 2: Evgenij1977 ($7.78 in chips) 
Seat 3: play4winfun ($12.14 in chips) 
Seat 4: Andra.Andu ($31.17 in chips) 
Seat 5: WI7ZZ ($9.85 in chips) 
Seat 6: kotlecior ($10.28 in chips) 
Evgenij1977: posts small blind $0.05
play4winfun: posts big blind $0.10
*** HOLE CARDS ***
Dealt to WI7ZZ [Ac 6c]
Andra.Andu: folds 
WI7ZZ: raises $0.21 to $0.31
kotlecior: folds 
1_gaborik: folds 
Evgenij1977: folds 
play4winfun: folds 
Uncalled bet ($0.21) returned to WI7ZZ
WI7ZZ collected $0.25 from pot
WI7ZZ: doesn't show hand 
*** SUMMARY ***
Total pot $0.25 | Rake $0 
Seat 1: 1_gaborik (button) folded before Flop (didn't bet)
Seat 2: Evgenij1977 (small blind) folded before Flop
Seat 3: play4winfun (big blind) folded before Flop
Seat 4: Andra.Andu folded before Flop (didn't bet)
Seat 5: WI7ZZ collected ($0.25)
Seat 6: kotlecior folded before Flop (didn't bet)



PokerStars Zoom Hand #188748984657:  Hold'em No Limit ($0.05/$0.10) - 2018/07/15 13:55:56 WET [2018/07/15 8:55:56 ET]
Table 'Aludra' 6-max Seat #1 is the button
Seat 1: WI7ZZ ($9.85 in chips) 
Seat 2: 62MacDaddy ($7.49 in chips) 
Seat 3: elWacki ($10.97 in chips) 
Seat 4: tweeK1001 ($10 in chips) 
Seat 5: kotlecior ($10.38 in chips) 
Seat 6: San4eZzz77 ($11.25 in chips) 
62MacDaddy: posts small blind $0.05
elWacki: posts big blind $0.10
*** HOLE CARDS ***
Dealt to WI7ZZ [2d 9d]
tweeK1001: folds 
kotlecior: folds 
San4eZzz77: folds 
WI7ZZ: folds 
62MacDaddy: calls $0.05
elWacki: checks 
*** FLOP *** [Qs Ah 3h]
62MacDaddy: bets $0.10
elWacki: calls $0.10
*** TURN *** [Qs Ah 3h] [5d]
62MacDaddy: bets $0.20
elWacki: calls $0.20
*** RIVER *** [Qs Ah 3h 5d] [5c]
62MacDaddy: bets $0.30
elWacki: calls $0.30
*** SHOW DOWN ***
62MacDaddy: shows [Ac 3s] (two pair, Aces and Fives)
elWacki: shows [As 7c] (two pair, Aces and Fives)
62MacDaddy collected $0.67 from pot
elWacki collected $0.67 from pot
*** SUMMARY ***
Total pot $1.40 | Rake $0.06 
Board [Qs Ah 3h 5d 5c]
Seat 1: WI7ZZ (button) folded before Flop (didn't bet)
Seat 2: 62MacDaddy (small blind) showed [Ac 3s] and won ($0.67) with two pair, Aces and Fives
Seat 3: elWacki (big blind) showed [As 7c] and won ($0.67) with two pair, Aces and Fives
Seat 4: tweeK1001 folded before Flop (didn't bet)
Seat 5: kotlecior folded before Flop (didn't bet)
Seat 6: San4eZzz77 folded before Flop (didn't bet)



PokerStars Zoom Hand #188748994501:  Hold'em No Limit ($0.05/$0.10) - 2018/07/15 13:56:20 WET [2018/07/15 8:56:20 ET]
Table 'Aludra' 6-max Seat #1 is the button
Seat 1: WI7ZZ ($10 in chips) 
Seat 2: andremgremio ($14.15 in chips) 
Seat 3: michaltoja ($10.97 in chips) 
Seat 4: WhiteDAGLeki ($10.44 in chips) 
Seat 5: LukksAA ($10.55 in chips) 
Seat 6: CojocaruSV ($21.63 in chips) 
andremgremio: posts small blind $0.05
michaltoja: posts big blind $0.10
*** HOLE CARDS ***
Dealt to WI7ZZ [2d 8s]
WhiteDAGLeki: folds 
LukksAA: folds 
CojocaruSV: raises $0.30 to $0.40
WI7ZZ: folds 
andremgremio: folds 
michaltoja: folds 
Uncalled bet ($0.30) returned to CojocaruSV
CojocaruSV collected $0.25 from pot
CojocaruSV: doesn't show hand 
*** SUMMARY ***
Total pot $0.25 | Rake $0 
Seat 1: WI7ZZ (button) folded before Flop (didn't bet)
Seat 2: andremgremio (small blind) folded before Flop
Seat 3: michaltoja (big blind) folded before Flop
Seat 4: WhiteDAGLeki folded before Flop (didn't bet)
Seat 5: LukksAA folded before Flop (didn't bet)
Seat 6: CojocaruSV collected ($0.25)



PokerStars Zoom Hand #188749002323:  Hold'em No Limit ($0.05/$0.10) - 2018/07/15 13:56:39 WET [2018/07/15 8:56:39 ET]
Table 'Aludra' 6-max Seat #1 is the button
Seat 1: oberkellner6 ($6.41 in chips) 
Seat 2: WI7ZZ ($9.90 in chips) 
Seat 3: hansing81 ($11.28 in chips) 
Seat 4: rack1777 ($14.19 in chips) 
Seat 5: mqsan ($10.71 in chips) 
Seat 6: Sunrise1912 ($12.72 in chips) 
WI7ZZ: posts small blind $0.05
hansing81: posts big blind $0.10
*** HOLE CARDS ***
Dealt to WI7ZZ [3s Ks]
rack1777: folds 
mqsan: folds 
Sunrise1912: folds 
oberkellner6: folds 
WI7ZZ: folds 
Uncalled bet ($0.05) returned to hansing81
hansing81 collected $0.10 from pot
hansing81: doesn't show hand 
*** SUMMARY ***
Total pot $0.10 | Rake $0 
Seat 1: oberkellner6 (button) folded before Flop (didn't bet)
Seat 2: WI7ZZ (small blind) folded before Flop
Seat 3: hansing81 (big blind) collected ($0.10)
Seat 4: rack1777 folded before Flop (didn't bet)
Seat 5: mqsan folded before Flop (didn't bet)
Seat 6: Sunrise1912 folded before Flop (didn't bet)



PokerStars Zoom Hand #188748995726:  Hold'em No Limit ($0.05/$0.10) - 2018/07/15 13:56:23 WET [2018/07/15 8:56:23 ET]
Table 'Aludra' 6-max Seat #1 is the button
Seat 1: elWacki ($10.94 in chips) 
Seat 2: actionMoon ($10 in chips) 
Seat 3: WI7ZZ ($10 in chips) 
Seat 4: ChungkingExp ($18.38 in chips) 
Seat 5: toms8801 ($15.64 in chips) 
Seat 6: XXschmidtX ($11.45 in chips) 
actionMoon: posts small blind $0.05
WI7ZZ: posts big blind $0.10
*** HOLE CARDS ***
Dealt to WI7ZZ [5s 4h]
ChungkingExp: folds 
toms8801: folds 
XXschmidtX: raises $0.15 to $0.25
elWacki: raises $0.50 to $0.75
actionMoon: folds 
WI7ZZ: folds 
XXschmidtX: folds 
Uncalled bet ($0.50) returned to elWacki
elWacki collected $0.65 from pot
elWacki: doesn't show hand 
*** SUMMARY ***
Total pot $0.65 | Rake $0 
Seat 1: elWacki (button) collected ($0.65)
Seat 2: actionMoon (small blind) folded before Flop
Seat 3: WI7ZZ (big blind) folded before Flop
Seat 4: ChungkingExp folded before Flop (didn't bet)
Seat 5: toms8801 folded before Flop (didn't bet)
Seat 6: XXschmidtX folded before Flop



PokerStars Zoom Hand #188749003553:  Hold'em No Limit ($0.05/$0.10) - 2018/07/15 13:56:42 WET [2018/07/15 8:56:42 ET]
Table 'Aludra' 6-max Seat #1 is the button
Seat 1: niqqa48 ($29.59 in chips) 
Seat 2: inglorious6 ($10.58 in chips) 
Seat 3: Pardaroxon ($10.15 in chips) 
Seat 4: SKD TEAM PRO ($10.45 in chips) 
Seat 5: WI7ZZ ($9.85 in chips) 
Seat 6: incredibleuh ($9.42 in chips) 
inglorious6: posts small blind $0.05
Pardaroxon: posts big blind $0.10
*** HOLE CARDS ***
Dealt to WI7ZZ [Kh Ks]
SKD TEAM PRO: folds 
WI7ZZ: raises $0.21 to $0.31
incredibleuh: folds 
niqqa48: folds 
inglorious6: folds 
Pardaroxon: folds 
Uncalled bet ($0.21) returned to WI7ZZ
WI7ZZ collected $0.25 from pot
WI7ZZ: doesn't show hand 
*** SUMMARY ***
Total pot $0.25 | Rake $0 
Seat 1: niqqa48 (button) folded before Flop (didn't bet)
Seat 2: inglorious6 (small blind) folded before Flop
Seat 3: Pardaroxon (big blind) folded before Flop
Seat 4: SKD TEAM PRO folded before Flop (didn't bet)
Seat 5: WI7ZZ collected ($0.25)
Seat 6: incredibleuh folded before Flop (didn't bet)



PokerStars Zoom Hand #188749009755:  Hold'em No Limit ($0.05/$0.10) - 2018/07/15 13:56:57 WET [2018/07/15 8:56:57 ET]
Table 'Aludra' 6-max Seat #1 is the button
Seat 1: M.Hakk1nen ($6.07 in chips) 
Seat 2: padde886 ($10 in chips) 
Seat 3: pushi2 ($12.20 in chips) 
Seat 4: wongkosolsuk ($10.05 in chips) 
Seat 5: universe123 ($9.87 in chips) 
Seat 6: WI7ZZ ($10 in chips) 
padde886: posts small blind $0.05
pushi2: posts big blind $0.10
*** HOLE CARDS ***
Dealt to WI7ZZ [Jh 4h]
wongkosolsuk: folds 
universe123: folds 
WI7ZZ: folds 
M.Hakk1nen: folds 
padde886: raises $0.20 to $0.30
pushi2: folds 
Uncalled bet ($0.20) returned to padde886
padde886 collected $0.20 from pot
padde886: doesn't show hand 
*** SUMMARY ***
Total pot $0.20 | Rake $0 
Seat 1: M.Hakk1nen (button) folded before Flop (didn't bet)
Seat 2: padde886 (small blind) collected ($0.20)
Seat 3: pushi2 (big blind) folded before Flop
Seat 4: wongkosolsuk folded before Flop (didn't bet)
Seat 5: universe123 folded before Flop (didn't bet)
Seat 6: WI7ZZ folded before Flop (didn't bet)



PokerStars Zoom Hand #188749013953:  Hold'em No Limit ($0.05/$0.10) - 2018/07/15 13:57:07 WET [2018/07/15 8:57:07 ET]
Table 'Aludra' 6-max Seat #1 is the button
Seat 1: actionMoon ($10 in chips) 
Seat 2: xjonnyx80 ($9.90 in chips) 
Seat 3: WI7ZZ ($10 in chips) 
Seat 4: R2R2806 ($10 in chips) 
Seat 5: MOU77Y ($10 in chips) 
Seat 6: padde886 ($10.02 in chips) 
xjonnyx80: posts small blind $0.05
WI7ZZ: posts big blind $0.10
*** HOLE CARDS ***
Dealt to WI7ZZ [7h 5s]
R2R2806: folds 
MOU77Y: folds 
padde886: folds 
actionMoon: raises $0.14 to $0.24
xjonnyx80: folds 
WI7ZZ: folds 
Uncalled bet ($0.14) returned to actionMoon
actionMoon collected $0.25 from pot
*** SUMMARY ***
Total pot $0.25 | Rake $0 
Seat 1: actionMoon (button) collected ($0.25)
Seat 2: xjonnyx80 (small blind) folded before Flop
Seat 3: WI7ZZ (big blind) folded before Flop
Seat 4: R2R2806 folded before Flop (didn't bet)
Seat 5: MOU77Y folded before Flop (didn't bet)
Seat 6: padde886 folded before Flop (didn't bet)



PokerStars Zoom Hand #188749012683:  Hold'em No Limit ($0.05/$0.10) - 2018/07/15 13:57:04 WET [2018/07/15 8:57:04 ET]
Table 'Aludra' 6-max Seat #1 is the button
Seat 1: actionMoon ($10 in chips) 
Seat 2: lesik1979 ($12.42 in chips) 
Seat 3: signofme ($10 in chips) 
Seat 4: WI7ZZ ($10 in chips) 
Seat 5: g.kotzas ($17.34 in chips) 
Seat 6: SickDayNight ($10.80 in chips) 
lesik1979: posts small blind $0.05
signofme: posts big blind $0.10
*** HOLE CARDS ***
Dealt to WI7ZZ [9d 6d]
WI7ZZ: folds 
g.kotzas: folds 
SickDayNight: raises $0.25 to $0.35
actionMoon: folds 
lesik1979: folds 
signofme: folds 
Uncalled bet ($0.25) returned to SickDayNight
SickDayNight collected $0.25 from pot
SickDayNight: doesn't show hand 
*** SUMMARY ***
Total pot $0.25 | Rake $0 
Seat 1: actionMoon (button) folded before Flop (didn't bet)
Seat 2: lesik1979 (small blind) folded before Flop
Seat 3: signofme (big blind) folded before Flop
Seat 4: WI7ZZ folded before Flop (didn't bet)
Seat 5: g.kotzas folded before Flop (didn't bet)
Seat 6: SickDayNight collected ($0.25)



PokerStars Zoom Hand #188749011047:  Hold'em No Limit ($0.05/$0.10) - 2018/07/15 13:57:00 WET [2018/07/15 8:57:00 ET]
Table 'Aludra' 6-max Seat #1 is the button
Seat 1: 1_gaborik ($14.39 in chips) 
Seat 2: Kindman15 ($11.18 in chips) 
Seat 3: IcePunishU ($18.59 in chips) 
Seat 4: WI7ZZ ($10 in chips) 
Seat 5: samurai ume ($10.17 in chips) 
Seat 6: R2R2806 ($11.35 in chips) 
Kindman15: posts small blind $0.05
IcePunishU: posts big blind $0.10
*** HOLE CARDS ***
Dealt to WI7ZZ [8s 3d]
WI7ZZ: folds 
samurai ume: folds 
R2R2806: folds 
1_gaborik: raises $0.15 to $0.25
Kindman15: calls $0.20
IcePunishU: calls $0.15
*** FLOP *** [2c Js 4c]
Kindman15: checks 
IcePunishU: checks 
1_gaborik: bets $0.25
Kindman15: folds 
IcePunishU: folds 
Uncalled bet ($0.25) returned to 1_gaborik
1_gaborik collected $0.72 from pot
1_gaborik: doesn't show hand 
*** SUMMARY ***
Total pot $0.75 | Rake $0.03 
Board [2c Js 4c]
Seat 1: 1_gaborik (button) collected ($0.72)
Seat 2: Kindman15 (small blind) folded on the Flop
Seat 3: IcePunishU (big blind) folded on the Flop
Seat 4: WI7ZZ folded before Flop (didn't bet)
Seat 5: samurai ume folded before Flop (didn't bet)
Seat 6: R2R2806 folded before Flop (didn't bet)



PokerStars Zoom Hand #188749024440:  Hold'em No Limit ($0.05/$0.10) - 2018/07/15 13:57:32 WET [2018/07/15 8:57:32 ET]
Table 'Aludra' 6-max Seat #1 is the button
Seat 1: WI7ZZ ($9.85 in chips) 
Seat 2: kocyk 7 ($28.36 in chips) 
Seat 3: jump9922 ($19.37 in chips) 
Seat 4: rack1777 ($14.15 in chips) 
Seat 5: Toxa512 ($25.33 in chips) 
Seat 6: Cronus2013 ($10.60 in chips) 
kocyk 7: posts small blind $0.05
jump9922: posts big blind $0.10
*** HOLE CARDS ***
Dealt to WI7ZZ [Kh 4s]
rack1777: folds 
Toxa512: folds 
Cronus2013: folds 
WI7ZZ: folds 
kocyk 7: raises $0.20 to $0.30
jump9922: folds 
Uncalled bet ($0.20) returned to kocyk 7
kocyk 7 collected $0.20 from pot
kocyk 7: doesn't show hand 
*** SUMMARY ***
Total pot $0.20 | Rake $0 
Seat 1: WI7ZZ (button) folded before Flop (didn't bet)
Seat 2: kocyk 7 (small blind) collected ($0.20)
Seat 3: jump9922 (big blind) folded before Flop
Seat 4: rack1777 folded before Flop (didn't bet)
Seat 5: Toxa512 folded before Flop (didn't bet)
Seat 6: Cronus2013 folded before Flop (didn't bet)



PokerStars Zoom Hand #188749027773:  Hold'em No Limit ($0.05/$0.10) - 2018/07/15 13:57:40 WET [2018/07/15 8:57:40 ET]
Table 'Aludra' 6-max Seat #1 is the button
Seat 1: ostant ($11.48 in chips) 
Seat 2: HebeFans ($10 in chips) 
Seat 3: scotseng ($11.69 in chips) 
Seat 4: WhiteDAGLeki ($14.71 in chips) 
Seat 5: negreanuNya ($10 in chips) 
Seat 6: WI7ZZ ($9.85 in chips) 
HebeFans: posts small blind $0.05
scotseng: posts big blind $0.10
*** HOLE CARDS ***
Dealt to WI7ZZ [5d 9h]
WhiteDAGLeki: folds 
negreanuNya: folds 
WI7ZZ: folds 
ostant: raises $0.20 to $0.30
HebeFans: folds 
scotseng: folds 
Uncalled bet ($0.20) returned to ostant
ostant collected $0.25 from pot
ostant: doesn't show hand 
*** SUMMARY ***
Total pot $0.25 | Rake $0 
Seat 1: ostant (button) collected ($0.25)
Seat 2: HebeFans (small blind) folded before Flop
Seat 3: scotseng (big blind) folded before Flop
Seat 4: WhiteDAGLeki folded before Flop (didn't bet)
Seat 5: negreanuNya folded before Flop (didn't bet)
Seat 6: WI7ZZ folded before Flop (didn't bet)



PokerStars Zoom Hand #188749022815:  Hold'em No Limit ($0.05/$0.10) - 2018/07/15 13:57:28 WET [2018/07/15 8:57:28 ET]
Table 'Aludra' 6-max Seat #1 is the button
Seat 1: Hansestadt1910 ($25.66 in chips) 
Seat 2: WI7ZZ ($9.90 in chips) 
Seat 3: Tamexo ($19.89 in chips) 
Seat 4: GROM84 ($13.52 in chips) 
Seat 5: MOU77Y ($10 in chips) 
Seat 6: Spooks1337 ($14.31 in chips) 
WI7ZZ: posts small blind $0.05
Tamexo: posts big blind $0.10
*** HOLE CARDS ***
Dealt to WI7ZZ [Kh 7d]
GROM84: folds 
MOU77Y has timed out
MOU77Y: folds 
Spooks1337: folds 
Hansestadt1910: folds 
WI7ZZ: folds 
Uncalled bet ($0.05) returned to Tamexo
Tamexo collected $0.10 from pot
Tamexo: doesn't show hand 
*** SUMMARY ***
Total pot $0.10 | Rake $0 
Seat 1: Hansestadt1910 (button) folded before Flop (didn't bet)
Seat 2: WI7ZZ (small blind) folded before Flop
Seat 3: Tamexo (big blind) collected ($0.10)
Seat 4: GROM84 folded before Flop (didn't bet)
Seat 5: MOU77Y folded before Flop (didn't bet)
Seat 6: Spooks1337 folded before Flop (didn't bet)



PokerStars Zoom Hand #188749028956:  Hold'em No Limit ($0.05/$0.10) - 2018/07/15 13:57:43 WET [2018/07/15 8:57:43 ET]
Table 'Aludra' 6-max Seat #1 is the button
Seat 1: hastyboots ($11.56 in chips) 
Seat 2: andypr0 ($24.11 in chips) 
Seat 3: actionMoon ($10.35 in chips) 
Seat 4: DIMAN 75976 ($20.39 in chips) 
Seat 5: WI7ZZ ($9.85 in chips) 
Seat 6: crazy8843 ($8.65 in chips) 
andypr0: posts small blind $0.05
actionMoon: posts big blind $0.10
*** HOLE CARDS ***
Dealt to WI7ZZ [7h 8h]
DIMAN 75976: folds 
WI7ZZ: raises $0.21 to $0.31
crazy8843: folds 
hastyboots: folds 
andypr0: folds 
actionMoon: folds 
Uncalled bet ($0.21) returned to WI7ZZ
WI7ZZ collected $0.25 from pot
WI7ZZ: doesn't show hand 
*** SUMMARY ***
Total pot $0.25 | Rake $0 
Seat 1: hastyboots (button) folded before Flop (didn't bet)
Seat 2: andypr0 (small blind) folded before Flop
Seat 3: actionMoon (big blind) folded before Flop
Seat 4: DIMAN 75976 folded before Flop (didn't bet)
Seat 5: WI7ZZ collected ($0.25)
Seat 6: crazy8843 folded before Flop (didn't bet)



PokerStars Zoom Hand #188749040892:  Hold'em No Limit ($0.05/$0.10) - 2018/07/15 13:58:11 WET [2018/07/15 8:58:11 ET]
Table 'Aludra' 6-max Seat #1 is the button
Seat 1: QuakieMan ($18.14 in chips) 
Seat 2: kotlecior ($16.60 in chips) 
Seat 3: WI7ZZ ($10 in chips) 
Seat 4: Anton93726 ($9.88 in chips) 
Seat 5: Predtecha87 ($10.60 in chips) 
Seat 6: signofme ($14.28 in chips) 
kotlecior: posts small blind $0.05
WI7ZZ: posts big blind $0.10
*** HOLE CARDS ***
Dealt to WI7ZZ [Jc 9h]
Anton93726: folds 
Predtecha87: folds 
signofme: raises $0.20 to $0.30
QuakieMan: folds 
kotlecior: folds 
WI7ZZ: folds 
Uncalled bet ($0.20) returned to signofme
signofme collected $0.25 from pot
*** SUMMARY ***
Total pot $0.25 | Rake $0 
Seat 1: QuakieMan (button) folded before Flop (didn't bet)
Seat 2: kotlecior (small blind) folded before Flop
Seat 3: WI7ZZ (big blind) folded before Flop
Seat 4: Anton93726 folded before Flop (didn't bet)
Seat 5: Predtecha87 folded before Flop (didn't bet)
Seat 6: signofme collected ($0.25)



PokerStars Zoom Hand #188749039650:  Hold'em No Limit ($0.05/$0.10) - 2018/07/15 13:58:08 WET [2018/07/15 8:58:08 ET]
Table 'Aludra' 6-max Seat #1 is the button
Seat 1: Aarons AA ($11.19 in chips) 
Seat 2: padde886 ($10 in chips) 
Seat 3: checkAAmarc ($10 in chips) 
Seat 4: ostant ($11.53 in chips) 
Seat 5: WI7ZZ ($10 in chips) 
Seat 6: Sheremetov88 ($15.80 in chips) 
padde886: posts small blind $0.05
checkAAmarc: posts big blind $0.10
*** HOLE CARDS ***
Dealt to WI7ZZ [5s 2s]
ostant: folds 
WI7ZZ: folds 
Sheremetov88: folds 
Aarons AA: raises $0.12 to $0.22
padde886: folds 
checkAAmarc has timed out while disconnected
checkAAmarc: folds 
Uncalled bet ($0.12) returned to Aarons AA
Aarons AA collected $0.25 from pot
Aarons AA: doesn't show hand 
*** SUMMARY ***
Total pot $0.25 | Rake $0 
Seat 1: Aarons AA (button) collected ($0.25)
Seat 2: padde886 (small blind) folded before Flop
Seat 3: checkAAmarc (big blind) folded before Flop
Seat 4: ostant folded before Flop (didn't bet)
Seat 5: WI7ZZ folded before Flop (didn't bet)
Seat 6: Sheremetov88 folded before Flop (didn't bet)



PokerStars Zoom Hand #188749025706:  Hold'em No Limit ($0.05/$0.10) - 2018/07/15 13:57:35 WET [2018/07/15 8:57:35 ET]
Table 'Aludra' 6-max Seat #1 is the button
Seat 1: lesik1979 ($17.72 in chips) 
Seat 2: Mr.Terek ($9.90 in chips) 
Seat 3: TestaDiCazz ($10.61 in chips) 
Seat 4: WI7ZZ ($9.85 in chips) 
Seat 5: actionMoon ($10 in chips) 
Seat 6: Jarness II ($10.83 in chips) 
Mr.Terek: posts small blind $0.05
TestaDiCazz: posts big blind $0.10
*** HOLE CARDS ***
Dealt to WI7ZZ [Kd 3d]
WI7ZZ: folds 
actionMoon: raises $0.18 to $0.28
Jarness II: folds 
lesik1979: calls $0.28
Mr.Terek: folds 
TestaDiCazz: folds 
*** FLOP *** [4c Ad 6h]
actionMoon: bets $0.45
lesik1979: calls $0.45
*** TURN *** [4c Ad 6h] [8d]
actionMoon: checks 
lesik1979: checks 
*** RIVER *** [4c Ad 6h 8d] [3h]
actionMoon: checks 
lesik1979: checks 
*** SHOW DOWN ***
actionMoon: shows [Kc Qc] (high card Ace)
lesik1979: shows [9d 9s] (a pair of Nines)
lesik1979 collected $1.54 from pot
*** SUMMARY ***
Total pot $1.61 | Rake $0.07 
Board [4c Ad 6h 8d 3h]
Seat 1: lesik1979 (button) showed [9d 9s] and won ($1.54) with a pair of Nines
Seat 2: Mr.Terek (small blind) folded before Flop
Seat 3: TestaDiCazz (big blind) folded before Flop
Seat 4: WI7ZZ folded before Flop (didn't bet)
Seat 5: actionMoon showed [Kc Qc] and lost with high card Ace
Seat 6: Jarness II folded before Flop (didn't bet)



PokerStars Zoom Hand #188749047250:  Hold'em No Limit ($0.05/$0.10) - 2018/07/15 13:58:26 WET [2018/07/15 8:58:26 ET]
Table 'Aludra' 6-max Seat #1 is the button
Seat 1: WI7ZZ ($9.85 in chips) 
Seat 2: sTIKs21 ($12.91 in chips) 
Seat 3: FITMTLA ($15.22 in chips) 
Seat 4: GROM84 ($10.15 in chips) 
Seat 5: HebeFans ($11.20 in chips) 
Seat 6: Lily710 ($18.02 in chips) 
sTIKs21: posts small blind $0.05
FITMTLA: posts big blind $0.10
*** HOLE CARDS ***
Dealt to WI7ZZ [9s 2d]
GROM84: folds 
HebeFans: folds 
Lily710: folds 
WI7ZZ: folds 
sTIKs21: raises $0.15 to $0.25
FITMTLA: folds 
Uncalled bet ($0.15) returned to sTIKs21
sTIKs21 collected $0.20 from pot
sTIKs21: doesn't show hand 
*** SUMMARY ***
Total pot $0.20 | Rake $0 
Seat 1: WI7ZZ (button) folded before Flop (didn't bet)
Seat 2: sTIKs21 (small blind) collected ($0.20)
Seat 3: FITMTLA (big blind) folded before Flop
Seat 4: GROM84 folded before Flop (didn't bet)
Seat 5: HebeFans folded before Flop (didn't bet)
Seat 6: Lily710 folded before Flop (didn't bet)



PokerStars Zoom Hand #188749046387:  Hold'em No Limit ($0.05/$0.10) - 2018/07/15 13:58:24 WET [2018/07/15 8:58:24 ET]
Table 'Aludra' 6-max Seat #1 is the button
Seat 1: Kandidic ($15.51 in chips) 
Seat 2: WI7ZZ ($9.90 in chips) 
Seat 3: Mr.Terek ($9.82 in chips) 
Seat 4: tweeK1001 ($10.62 in chips) 
Seat 5: lesik1979 ($25.03 in chips) 
Seat 6: mqsan ($21.68 in chips) 
WI7ZZ: posts small blind $0.05
Mr.Terek: posts big blind $0.10
*** HOLE CARDS ***
Dealt to WI7ZZ [6h 2c]
tweeK1001: folds 
lesik1979: raises $0.20 to $0.30
mqsan: folds 
Kandidic: folds 
WI7ZZ: folds 
Mr.Terek: calls $0.20
*** FLOP *** [Tc 6d 3d]
Mr.Terek: checks 
lesik1979: checks 
*** TURN *** [Tc 6d 3d] [9c]
Mr.Terek: bets $0.41
lesik1979: calls $0.41
*** RIVER *** [Tc 6d 3d 9c] [4h]
Mr.Terek: checks 
lesik1979: checks 
*** SHOW DOWN ***
Mr.Terek: shows [9d Qd] (a pair of Nines)
lesik1979: mucks hand 
Mr.Terek collected $1.40 from pot
*** SUMMARY ***
Total pot $1.47 | Rake $0.07 
Board [Tc 6d 3d 9c 4h]
Seat 1: Kandidic (button) folded before Flop (didn't bet)
Seat 2: WI7ZZ (small blind) folded before Flop
Seat 3: Mr.Terek (big blind) showed [9d Qd] and won ($1.40) with a pair of Nines
Seat 4: tweeK1001 folded before Flop (didn't bet)
Seat 5: lesik1979 mucked [Qc Kh]
Seat 6: mqsan folded before Flop (didn't bet)



PokerStars Zoom Hand #188749048904:  Hold'em No Limit ($0.05/$0.10) - 2018/07/15 13:58:30 WET [2018/07/15 8:58:30 ET]
Table 'Aludra' 6-max Seat #1 is the button
Seat 1: SydneyBridge ($10.83 in chips) 
Seat 2: michaltoja ($11.12 in chips) 
Seat 3: IcePunishU ($18.29 in chips) 
Seat 4: Sergdoc71rus ($4.53 in chips) 
Seat 5: tweeK1001 ($10.38 in chips) 
Seat 6: WI7ZZ ($9.85 in chips) 
michaltoja: posts small blind $0.05
IcePunishU: posts big blind $0.10
*** HOLE CARDS ***
Dealt to WI7ZZ [7h 8h]
Sergdoc71rus: calls $0.10
tweeK1001: folds 
WI7ZZ: folds 
SydneyBridge: folds 
michaltoja: folds 
IcePunishU: checks 
*** FLOP *** [4h 6h 7c]
IcePunishU: checks 
Sergdoc71rus: checks 
*** TURN *** [4h 6h 7c] [6c]
IcePunishU: bets $0.23
Sergdoc71rus: calls $0.23
*** RIVER *** [4h 6h 7c 6c] [4s]
IcePunishU: bets $1.20
Sergdoc71rus: folds 
Uncalled bet ($1.20) returned to IcePunishU
IcePunishU collected $0.68 from pot
IcePunishU: doesn't show hand 
*** SUMMARY ***
Total pot $0.71 | Rake $0.03 
Board [4h 6h 7c 6c 4s]
Seat 1: SydneyBridge (button) folded before Flop (didn't bet)
Seat 2: michaltoja (small blind) folded before Flop
Seat 3: IcePunishU (big blind) collected ($0.68)
Seat 4: Sergdoc71rus folded on the River
Seat 5: tweeK1001 folded before Flop (didn't bet)
Seat 6: WI7ZZ folded before Flop (didn't bet)



PokerStars Zoom Hand #188749050168:  Hold'em No Limit ($0.05/$0.10) - 2018/07/15 13:58:33 WET [2018/07/15 8:58:33 ET]
Table 'Aludra' 6-max Seat #1 is the button
Seat 1: ChungkingExp ($17.89 in chips) 
Seat 2: Lazy_dog[ru] ($10.95 in chips) 
Seat 3: WI7ZZ ($9.85 in chips) 
Seat 4: Radomir 26 ($10 in chips) 
Seat 5: Spooks1337 ($24.92 in chips) 
Seat 6: Cronus2013 ($10.79 in chips) 
Lazy_dog[ru]: posts small blind $0.05
WI7ZZ: posts big blind $0.10
*** HOLE CARDS ***
Dealt to WI7ZZ [Qs 2s]
Radomir 26: folds 
Spooks1337: folds 
Cronus2013: raises $0.12 to $0.22
ChungkingExp: raises $0.44 to $0.66
Lazy_dog[ru]: folds 
WI7ZZ: folds 
Cronus2013: raises $1.29 to $1.95
ChungkingExp: folds 
Uncalled bet ($1.29) returned to Cronus2013
Cronus2013 collected $1.47 from pot
Cronus2013: doesn't show hand 
*** SUMMARY ***
Total pot $1.47 | Rake $0 
Seat 1: ChungkingExp (button) folded before Flop
Seat 2: Lazy_dog[ru] (small blind) folded before Flop
Seat 3: WI7ZZ (big blind) folded before Flop
Seat 4: Radomir 26 folded before Flop (didn't bet)
Seat 5: Spooks1337 folded before Flop (didn't bet)
Seat 6: Cronus2013 collected ($1.47)



PokerStars Zoom Hand #188749060490:  Hold'em No Limit ($0.05/$0.10) - 2018/07/15 13:58:58 WET [2018/07/15 8:58:58 ET]
Table 'Aludra' 6-max Seat #1 is the button
Seat 1: Spooks1337 ($33.05 in chips) 
Seat 2: W71W ($10.18 in chips) 
Seat 3: MYSTYRIOS ($5.16 in chips) 
Seat 4: avtur ($5.97 in chips) 
Seat 5: WI7ZZ ($9.75 in chips) 
Seat 6: naymaierbra ($10 in chips) 
W71W: posts small blind $0.05
MYSTYRIOS: posts big blind $0.10
*** HOLE CARDS ***
Dealt to WI7ZZ [Qd 2s]
avtur: folds 
WI7ZZ: folds 
naymaierbra: raises $0.20 to $0.30
Spooks1337: folds 
W71W: folds 
MYSTYRIOS: folds 
Uncalled bet ($0.20) returned to naymaierbra
naymaierbra collected $0.25 from pot
naymaierbra: doesn't show hand 
*** SUMMARY ***
Total pot $0.25 | Rake $0 
Seat 1: Spooks1337 (button) folded before Flop (didn't bet)
Seat 2: W71W (small blind) folded before Flop
Seat 3: MYSTYRIOS (big blind) folded before Flop
Seat 4: avtur folded before Flop (didn't bet)
Seat 5: WI7ZZ folded before Flop (didn't bet)
Seat 6: naymaierbra collected ($0.25)



PokerStars Zoom Hand #188749061794:  Hold'em No Limit ($0.05/$0.10) - 2018/07/15 13:59:01 WET [2018/07/15 8:59:01 ET]
Table 'Aludra' 6-max Seat #1 is the button
Seat 1: emi2210 ($26.76 in chips) 
Seat 2: WI7ZZ ($9.75 in chips) 
Seat 3: michaltoja ($10 in chips) 
Seat 4: 1_gaborik ($15.03 in chips) 
Seat 5: IcePunishU ($38.98 in chips) 
Seat 6: niqqa48 ($21.68 in chips) 
WI7ZZ: posts small blind $0.05
michaltoja: posts big blind $0.10
*** HOLE CARDS ***
Dealt to WI7ZZ [Ah Ts]
1_gaborik: raises $0.20 to $0.30
IcePunishU: folds 
niqqa48: folds 
emi2210: calls $0.30
WI7ZZ: raises $0.80 to $1.10
michaltoja: folds 
1_gaborik: folds 
emi2210: folds 
Uncalled bet ($0.80) returned to WI7ZZ
WI7ZZ collected $1 from pot
WI7ZZ: doesn't show hand 
*** SUMMARY ***
Total pot $1 | Rake $0 
Seat 1: emi2210 (button) folded before Flop
Seat 2: WI7ZZ (small blind) collected ($1)
Seat 3: michaltoja (big blind) folded before Flop
Seat 4: 1_gaborik folded before Flop
Seat 5: IcePunishU folded before Flop (didn't bet)
Seat 6: niqqa48 folded before Flop (didn't bet)



PokerStars Zoom Hand #188749084254:  Hold'em No Limit ($0.05/$0.10) - 2018/07/15 13:59:36 WET [2018/07/15 8:59:36 ET]
Table 'Aludra' 6-max Seat #1 is the button
Seat 1: WI7ZZ ($10.45 in chips) 
Seat 2: Circenses_p ($6.95 in chips) 
Seat 3: Lazy_dog[ru] ($10 in chips) 
Seat 4: blasterrrtje ($10.38 in chips) 
Seat 5: anthony1480 ($5.06 in chips) 
Seat 6: universe123 ($7.85 in chips) 
Circenses_p: posts small blind $0.05
Lazy_dog[ru]: posts big blind $0.10
*** HOLE CARDS ***
Dealt to WI7ZZ [2h 6s]
blasterrrtje: raises $0.20 to $0.30
anthony1480: folds 
universe123: folds 
WI7ZZ: folds 
Circenses_p: folds 
Lazy_dog[ru]: folds 
Uncalled bet ($0.20) returned to blasterrrtje
blasterrrtje collected $0.25 from pot
blasterrrtje: doesn't show hand 
*** SUMMARY ***
Total pot $0.25 | Rake $0 
Seat 1: WI7ZZ (button) folded before Flop (didn't bet)
Seat 2: Circenses_p (small blind) folded before Flop
Seat 3: Lazy_dog[ru] (big blind) folded before Flop
Seat 4: blasterrrtje collected ($0.25)
Seat 5: anthony1480 folded before Flop (didn't bet)
Seat 6: universe123 folded before Flop (didn't bet)



PokerStars Zoom Hand #188749085536:  Hold'em No Limit ($0.05/$0.10) - 2018/07/15 13:59:39 WET [2018/07/15 8:59:39 ET]
Table 'Aludra' 6-max Seat #1 is the button
Seat 1: universe123 ($7.85 in chips) 
Seat 2: rack1777 ($12.80 in chips) 
Seat 3: elWacki ($11.06 in chips) 
Seat 4: DobrikE.Al. ($15.70 in chips) 
Seat 5: hellf1re666 ($10 in chips) 
Seat 6: WI7ZZ ($10.45 in chips) 
rack1777: posts small blind $0.05
elWacki: posts big blind $0.10
*** HOLE CARDS ***
Dealt to WI7ZZ [5h Jd]
DobrikE.Al.: folds 
hellf1re666: folds 
WI7ZZ: folds 
universe123: folds 
rack1777: raises $0.10 to $0.20
elWacki: calls $0.10
*** FLOP *** [Jc 5s 5c]
rack1777: bets $0.30
elWacki: folds 
Uncalled bet ($0.30) returned to rack1777
rack1777 collected $0.38 from pot
rack1777: doesn't show hand 
*** SUMMARY ***
Total pot $0.40 | Rake $0.02 
Board [Jc 5s 5c]
Seat 1: universe123 (button) folded before Flop (didn't bet)
Seat 2: rack1777 (small blind) collected ($0.38)
Seat 3: elWacki (big blind) folded on the Flop
Seat 4: DobrikE.Al. folded before Flop (didn't bet)
Seat 5: hellf1re666 folded before Flop (didn't bet)
Seat 6: WI7ZZ folded before Flop (didn't bet)



PokerStars Zoom Hand #188749086806:  Hold'em No Limit ($0.05/$0.10) - 2018/07/15 13:59:42 WET [2018/07/15 8:59:42 ET]
Table 'Aludra' 6-max Seat #1 is the button
Seat 1: xjonnyx80 ($9.30 in chips) 
Seat 2: chp0ker7Let ($8.19 in chips) 
Seat 3: hellf1re666 ($10 in chips) 
Seat 4: WI7ZZ ($10.45 in chips) 
Seat 5: topmong4201 ($8.69 in chips) 
Seat 6: GuiBenites ($10 in chips) 
chp0ker7Let: posts small blind $0.05
hellf1re666: posts big blind $0.10
*** HOLE CARDS ***
Dealt to WI7ZZ [Ts Qc]
WI7ZZ: raises $0.26 to $0.36
topmong4201: folds 
GuiBenites: folds 
xjonnyx80: folds 
chp0ker7Let: folds 
hellf1re666: calls $0.26
*** FLOP *** [Kc 9s 5s]
hellf1re666: checks 
WI7ZZ: bets $0.33
hellf1re666: calls $0.33
*** TURN *** [Kc 9s 5s] [Th]
hellf1re666: checks 
WI7ZZ: bets $0.50
hellf1re666: calls $0.50
*** RIVER *** [Kc 9s 5s Th] [Kd]
hellf1re666: checks 
WI7ZZ: bets $0.80
hellf1re666: folds 
Uncalled bet ($0.80) returned to WI7ZZ
WI7ZZ collected $2.32 from pot
WI7ZZ: doesn't show hand 
*** SUMMARY ***
Total pot $2.43 | Rake $0.11 
Board [Kc 9s 5s Th Kd]
Seat 1: xjonnyx80 (button) folded before Flop (didn't bet)
Seat 2: chp0ker7Let (small blind) folded before Flop
Seat 3: hellf1re666 (big blind) folded on the River
Seat 4: WI7ZZ collected ($2.32)
Seat 5: topmong4201 folded before Flop (didn't bet)
Seat 6: GuiBenites folded before Flop (didn't bet)



PokerStars Zoom Hand #188749106949:  Hold'em No Limit ($0.05/$0.10) - 2018/07/15 14:00:29 WET [2018/07/15 9:00:29 ET]
Table 'Aludra' 6-max Seat #1 is the button
Seat 1: PeteFatman ($10 in chips) 
Seat 2: elWacki ($10.64 in chips) 
Seat 3: kotlecior ($10 in chips) 
Seat 4: HebeFans ($12.40 in chips) 
Seat 5: WI7ZZ ($11.58 in chips) 
Seat 6: Juurikas ($10.69 in chips) 
elWacki: posts small blind $0.05
kotlecior: posts big blind $0.10
*** HOLE CARDS ***
Dealt to WI7ZZ [3d Kh]
HebeFans: folds 
WI7ZZ: folds 
Juurikas: folds 
PeteFatman: raises $0.20 to $0.30
elWacki: folds 
kotlecior: folds 
Uncalled bet ($0.20) returned to PeteFatman
PeteFatman collected $0.25 from pot
PeteFatman: doesn't show hand 
*** SUMMARY ***
Total pot $0.25 | Rake $0 
Seat 1: PeteFatman (button) collected ($0.25)
Seat 2: elWacki (small blind) folded before Flop
Seat 3: kotlecior (big blind) folded before Flop
Seat 4: HebeFans folded before Flop (didn't bet)
Seat 5: WI7ZZ folded before Flop (didn't bet)
Seat 6: Juurikas folded before Flop (didn't bet)



PokerStars Zoom Hand #188749109560:  Hold'em No Limit ($0.05/$0.10) - 2018/07/15 14:00:35 WET [2018/07/15 9:00:35 ET]
Table 'Aludra' 6-max Seat #1 is the button
Seat 1: Clear water,No ($10.81 in chips) 
Seat 2: jayrsone ($10.66 in chips) 
Seat 3: WI7ZZ ($11.58 in chips) 
Seat 4: mqsan ($21.28 in chips) 
Seat 5: StamuGeorge ($3.16 in chips) 
Seat 6: sabje1981 ($15.60 in chips) 
jayrsone: posts small blind $0.05
WI7ZZ: posts big blind $0.10
*** HOLE CARDS ***
Dealt to WI7ZZ [Kh 4h]
mqsan: folds 
StamuGeorge: folds 
sabje1981: folds 
sabje1981 is disconnected 
Clear water,No: folds 
jayrsone: folds 
Uncalled bet ($0.05) returned to WI7ZZ
WI7ZZ collected $0.10 from pot
WI7ZZ: doesn't show hand 
*** SUMMARY ***
Total pot $0.10 | Rake $0 
Seat 1: Clear water,No (button) folded before Flop (didn't bet)
Seat 2: jayrsone (small blind) folded before Flop
Seat 3: WI7ZZ (big blind) collected ($0.10)
Seat 4: mqsan folded before Flop (didn't bet)
Seat 5: StamuGeorge folded before Flop (didn't bet)
Seat 6: sabje1981 folded before Flop (didn't bet)



PokerStars Zoom Hand #188749116237:  Hold'em No Limit ($0.05/$0.10) - 2018/07/15 14:00:50 WET [2018/07/15 9:00:50 ET]
Table 'Aludra' 6-max Seat #1 is the button
Seat 1: andypr0 ($17.37 in chips) 
Seat 2: WI7ZZ ($11.63 in chips) 
Seat 3: whitemanhbd ($19.16 in chips) 
Seat 4: elWacki ($10.59 in chips) 
Seat 5: miilio ($6.27 in chips) 
Seat 6: Day Day Up6 ($25.44 in chips) 
WI7ZZ: posts small blind $0.05
whitemanhbd: posts big blind $0.10
*** HOLE CARDS ***
Dealt to WI7ZZ [Kc Qh]
elWacki: folds 
miilio: folds 
Day Day Up6: folds 
andypr0: folds 
WI7ZZ: raises $0.21 to $0.31
whitemanhbd: calls $0.21
*** FLOP *** [9h Ad Ts]
WI7ZZ: checks 
whitemanhbd: checks 
*** TURN *** [9h Ad Ts] [Kh]
WI7ZZ: bets $0.26
whitemanhbd: calls $0.26
*** RIVER *** [9h Ad Ts Kh] [8h]
WI7ZZ: bets $0.48
whitemanhbd: calls $0.48
*** SHOW DOWN ***
WI7ZZ: shows [Kc Qh] (a pair of Kings)
whitemanhbd: mucks hand 
WI7ZZ collected $2.01 from pot
*** SUMMARY ***
Total pot $2.10 | Rake $0.09 
Board [9h Ad Ts Kh 8h]
Seat 1: andypr0 (button) folded before Flop (didn't bet)
Seat 2: WI7ZZ (small blind) showed [Kc Qh] and won ($2.01) with a pair of Kings
Seat 3: whitemanhbd (big blind) mucked [Kd 7h]
Seat 4: elWacki folded before Flop (didn't bet)
Seat 5: miilio folded before Flop (didn't bet)
Seat 6: Day Day Up6 folded before Flop (didn't bet)



PokerStars Zoom Hand #188749133375:  Hold'em No Limit ($0.05/$0.10) - 2018/07/15 14:01:27 WET [2018/07/15 9:01:27 ET]
Table 'Aludra' 6-max Seat #1 is the button
Seat 1: WI7ZZ ($12.59 in chips) 
Seat 2: mentaltony ($19.71 in chips) 
Seat 3: calthedude ($25.04 in chips) 
Seat 4: anthony1480 ($2.29 in chips) 
Seat 5: tweeK1001 ($11.88 in chips) 
Seat 6: Circenses_p ($19.14 in chips) 
mentaltony: posts small blind $0.05
calthedude: posts big blind $0.10
*** HOLE CARDS ***
Dealt to WI7ZZ [Ad Tc]
anthony1480: raises $2.19 to $2.29 and is all-in
tweeK1001: folds 
Circenses_p: folds 
WI7ZZ: calls $2.29
mentaltony: folds 
calthedude: folds 
*** FLOP *** [Th Ks Qh]
*** TURN *** [Th Ks Qh] [4d]
*** RIVER *** [Th Ks Qh 4d] [5c]
*** SHOW DOWN ***
anthony1480: shows [Ts Td] (three of a kind, Tens)
WI7ZZ: shows [Ad Tc] (a pair of Tens)
anthony1480 collected $4.52 from pot
*** SUMMARY ***
Total pot $4.73 | Rake $0.21 
Board [Th Ks Qh 4d 5c]
Seat 1: WI7ZZ (button) showed [Ad Tc] and lost with a pair of Tens
Seat 2: mentaltony (small blind) folded before Flop
Seat 3: calthedude (big blind) folded before Flop
Seat 4: anthony1480 showed [Ts Td] and won ($4.52) with three of a kind, Tens
Seat 5: tweeK1001 folded before Flop (didn't bet)
Seat 6: Circenses_p folded before Flop (didn't bet)



PokerStars Zoom Hand #188749146189:  Hold'em No Limit ($0.05/$0.10) - 2018/07/15 14:01:53 WET [2018/07/15 9:01:53 ET]
Table 'Aludra' 6-max Seat #1 is the button
Seat 1: Toxa512 ($21.97 in chips) 
Seat 2: Andreas Bich ($13.35 in chips) 
Seat 3: dzoint ($10 in chips) 
Seat 4: Blackdrago93 ($22.83 in chips) 
Seat 5: LukksAA ($10.10 in chips) 
Seat 6: WI7ZZ ($10.30 in chips) 
Andreas Bich: posts small blind $0.05
dzoint: posts big blind $0.10
*** HOLE CARDS ***
Dealt to WI7ZZ [Kc Th]
Blackdrago93: folds 
LukksAA: folds 
WI7ZZ: raises $0.21 to $0.31
Toxa512: folds 
Andreas Bich: folds 
dzoint: folds 
Uncalled bet ($0.21) returned to WI7ZZ
WI7ZZ collected $0.25 from pot
WI7ZZ: doesn't show hand 
*** SUMMARY ***
Total pot $0.25 | Rake $0 
Seat 1: Toxa512 (button) folded before Flop (didn't bet)
Seat 2: Andreas Bich (small blind) folded before Flop
Seat 3: dzoint (big blind) folded before Flop
Seat 4: Blackdrago93 folded before Flop (didn't bet)
Seat 5: LukksAA folded before Flop (didn't bet)
Seat 6: WI7ZZ collected ($0.25)



PokerStars Zoom Hand #188749155172:  Hold'em No Limit ($0.05/$0.10) - 2018/07/15 14:02:11 WET [2018/07/15 9:02:11 ET]
Table 'Aludra' 6-max Seat #1 is the button
Seat 1: 62MacDaddy ($8.76 in chips) 
Seat 2: HebeFans ($10.72 in chips) 
Seat 3: naymaierbra ($10.10 in chips) 
Seat 4: Hansestadt1910 ($27.38 in chips) 
Seat 5: WI7ZZ ($10.45 in chips) 
Seat 6: Lazy_dog[ru] ($10 in chips) 
HebeFans: posts small blind $0.05
naymaierbra: posts big blind $0.10
*** HOLE CARDS ***
Dealt to WI7ZZ [Ts Qs]
Hansestadt1910: folds 
WI7ZZ: raises $0.21 to $0.31
Lazy_dog[ru]: folds 
62MacDaddy: folds 
HebeFans: folds 
naymaierbra: folds 
Uncalled bet ($0.21) returned to WI7ZZ
WI7ZZ collected $0.25 from pot
WI7ZZ: doesn't show hand 
*** SUMMARY ***
Total pot $0.25 | Rake $0 
Seat 1: 62MacDaddy (button) folded before Flop (didn't bet)
Seat 2: HebeFans (small blind) folded before Flop
Seat 3: naymaierbra (big blind) folded before Flop
Seat 4: Hansestadt1910 folded before Flop (didn't bet)
Seat 5: WI7ZZ collected ($0.25)
Seat 6: Lazy_dog[ru] folded before Flop (didn't bet)



PokerStars Zoom Hand #188749164444:  Hold'em No Limit ($0.05/$0.10) - 2018/07/15 14:02:30 WET [2018/07/15 9:02:30 ET]
Table 'Aludra' 6-max Seat #1 is the button
Seat 1: crazy8843 ($6.36 in chips) 
Seat 2: hellf1re666 ($10 in chips) 
Seat 3: WI7ZZ ($10.60 in chips) 
Seat 4: knullig ($4.12 in chips) 
Seat 5: Vespao20 ($10 in chips) 
Seat 6: louis0606 ($9.36 in chips) 
hellf1re666: posts small blind $0.05
WI7ZZ: posts big blind $0.10
*** HOLE CARDS ***
Dealt to WI7ZZ [7h 5s]
knullig: folds 
Vespao20: folds 
louis0606: folds 
crazy8843: raises $0.10 to $0.20
hellf1re666: folds 
WI7ZZ: folds 
Uncalled bet ($0.10) returned to crazy8843
crazy8843 collected $0.25 from pot
crazy8843: doesn't show hand 
*** SUMMARY ***
Total pot $0.25 | Rake $0 
Seat 1: crazy8843 (button) collected ($0.25)
Seat 2: hellf1re666 (small blind) folded before Flop
Seat 3: WI7ZZ (big blind) folded before Flop
Seat 4: knullig folded before Flop (didn't bet)
Seat 5: Vespao20 folded before Flop (didn't bet)
Seat 6: louis0606 folded before Flop (didn't bet)



PokerStars Zoom Hand #188749176768:  Hold'em No Limit ($0.05/$0.10) - 2018/07/15 14:02:55 WET [2018/07/15 9:02:55 ET]
Table 'Aludra' 6-max Seat #1 is the button
Seat 1: kotlecior ($10.45 in chips) 
Seat 2: WI7ZZ ($10.50 in chips) 
Seat 3: Backgammoner ($10.39 in chips) 
Seat 4: Mcellod ($12.42 in chips) 
Seat 5: R2R2806 ($20.04 in chips) 
Seat 6: bradm195 ($10.64 in chips) 
WI7ZZ: posts small blind $0.05
Backgammoner: posts big blind $0.10
*** HOLE CARDS ***
Dealt to WI7ZZ [Jd 8d]
Mcellod: folds 
R2R2806: folds 
bradm195: folds 
kotlecior: raises $0.15 to $0.25
WI7ZZ: raises $0.55 to $0.80
Backgammoner: folds 
kotlecior: calls $0.55
*** FLOP *** [Td Qc 3h]
WI7ZZ: bets $0.71
kotlecior: calls $0.71
*** TURN *** [Td Qc 3h] [Ks]
WI7ZZ: bets $1.31
kotlecior: folds 
Uncalled bet ($1.31) returned to WI7ZZ
WI7ZZ collected $2.98 from pot
WI7ZZ: doesn't show hand 
*** SUMMARY ***
Total pot $3.12 | Rake $0.14 
Board [Td Qc 3h Ks]
Seat 1: kotlecior (button) folded on the Turn
Seat 2: WI7ZZ (small blind) collected ($2.98)
Seat 3: Backgammoner (big blind) folded before Flop
Seat 4: Mcellod folded before Flop (didn't bet)
Seat 5: R2R2806 folded before Flop (didn't bet)
Seat 6: bradm195 folded before Flop (didn't bet)



PokerStars Zoom Hand #188749198873:  Hold'em No Limit ($0.05/$0.10) - 2018/07/15 14:03:39 WET [2018/07/15 9:03:39 ET]
Table 'Aludra' 6-max Seat #1 is the button
Seat 1: WI7ZZ ($11.97 in chips) 
Seat 2: dzoint ($11.67 in chips) 
Seat 3: scotseng ($11.54 in chips) 
Seat 4: kotlecior ($32.61 in chips) 
Seat 5: topmong4201 ($6.12 in chips) 
Seat 6: Circenses_p ($21.68 in chips) 
dzoint: posts small blind $0.05
scotseng: posts big blind $0.10
*** HOLE CARDS ***
Dealt to WI7ZZ [Jd As]
kotlecior: folds 
topmong4201: raises $0.10 to $0.20
Circenses_p: calls $0.20
WI7ZZ: raises $0.80 to $1
dzoint: folds 
scotseng: folds 
topmong4201: folds 
Circenses_p: folds 
Uncalled bet ($0.80) returned to WI7ZZ
WI7ZZ collected $0.75 from pot
WI7ZZ: doesn't show hand 
*** SUMMARY ***
Total pot $0.75 | Rake $0 
Seat 1: WI7ZZ (button) collected ($0.75)
Seat 2: dzoint (small blind) folded before Flop
Seat 3: scotseng (big blind) folded before Flop
Seat 4: kotlecior folded before Flop (didn't bet)
Seat 5: topmong4201 folded before Flop
Seat 6: Circenses_p folded before Flop



PokerStars Zoom Hand #188749217776:  Hold'em No Limit ($0.05/$0.10) - 2018/07/15 14:04:17 WET [2018/07/15 9:04:17 ET]
Table 'Aludra' 6-max Seat #1 is the button
Seat 1: kamikaza11 ($10 in chips) 
Seat 2: bradm195 ($42.76 in chips) 
Seat 3: tvv.1978 ($10.41 in chips) 
Seat 4: WI7ZZ ($12.52 in chips) 
Seat 5: signofme ($12.85 in chips) 
Seat 6: AnHoCa ($10 in chips) 
bradm195: posts small blind $0.05
tvv.1978: posts big blind $0.10
*** HOLE CARDS ***
Dealt to WI7ZZ [Ac Kd]
WI7ZZ: raises $0.26 to $0.36
signofme: folds 
AnHoCa: folds 
kamikaza11: folds 
bradm195: folds 
tvv.1978: folds 
Uncalled bet ($0.26) returned to WI7ZZ
WI7ZZ collected $0.25 from pot
WI7ZZ: doesn't show hand 
*** SUMMARY ***
Total pot $0.25 | Rake $0 
Seat 1: kamikaza11 (button) folded before Flop (didn't bet)
Seat 2: bradm195 (small blind) folded before Flop
Seat 3: tvv.1978 (big blind) folded before Flop
Seat 4: WI7ZZ collected ($0.25)
Seat 5: signofme folded before Flop (didn't bet)
Seat 6: AnHoCa folded before Flop (didn't bet)



PokerStars Zoom Hand #188749223825:  Hold'em No Limit ($0.05/$0.10) - 2018/07/15 14:04:29 WET [2018/07/15 9:04:29 ET]
Table 'Aludra' 6-max Seat #1 is the button
Seat 1: AHOHHC ($10.14 in chips) 
Seat 2: shibachang ($10.22 in chips) 
Seat 3: Lily710 ($21.48 in chips) 
Seat 4: ChungkingExp ($22.85 in chips) 
Seat 5: WI7ZZ ($12.67 in chips) 
Seat 6: WhiteDAGLeki ($14.13 in chips) 
shibachang: posts small blind $0.05
Lily710: posts big blind $0.10
*** HOLE CARDS ***
Dealt to WI7ZZ [5s 8s]
ChungkingExp: folds 
WI7ZZ: folds 
WhiteDAGLeki: folds 
AHOHHC: raises $0.12 to $0.22
shibachang: folds 
Lily710: folds 
Uncalled bet ($0.12) returned to AHOHHC
AHOHHC collected $0.25 from pot
AHOHHC: doesn't show hand 
*** SUMMARY ***
Total pot $0.25 | Rake $0 
Seat 1: AHOHHC (button) collected ($0.25)
Seat 2: shibachang (small blind) folded before Flop
Seat 3: Lily710 (big blind) folded before Flop
Seat 4: ChungkingExp folded before Flop (didn't bet)
Seat 5: WI7ZZ folded before Flop (didn't bet)
Seat 6: WhiteDAGLeki folded before Flop (didn't bet)



PokerStars Zoom Hand #188749226847:  Hold'em No Limit ($0.05/$0.10) - 2018/07/15 14:04:35 WET [2018/07/15 9:04:35 ET]
Table 'Aludra' 6-max Seat #1 is the button
Seat 1: indextown ($11.40 in chips) 
Seat 2: KartenBob0815 ($15.32 in chips) 
Seat 3: WI7ZZ ($12.67 in chips) 
Seat 4: negreanuNya ($12.31 in chips) 
Seat 5: AloneWithU ($10 in chips) 
Seat 6: GROM84 ($11.12 in chips) 
KartenBob0815: posts small blind $0.05
WI7ZZ: posts big blind $0.10
*** HOLE CARDS ***
Dealt to WI7ZZ [7d Th]
negreanuNya: folds 
AloneWithU: folds 
GROM84: raises $0.13 to $0.23
indextown: folds 
KartenBob0815: folds 
WI7ZZ: folds 
Uncalled bet ($0.13) returned to GROM84
GROM84 collected $0.25 from pot
*** SUMMARY ***
Total pot $0.25 | Rake $0 
Seat 1: indextown (button) folded before Flop (didn't bet)
Seat 2: KartenBob0815 (small blind) folded before Flop
Seat 3: WI7ZZ (big blind) folded before Flop
Seat 4: negreanuNya folded before Flop (didn't bet)
Seat 5: AloneWithU folded before Flop (didn't bet)
Seat 6: GROM84 collected ($0.25)



PokerStars Zoom Hand #188749235895:  Hold'em No Limit ($0.05/$0.10) - 2018/07/15 14:04:53 WET [2018/07/15 9:04:53 ET]
Table 'Aludra' 6-max Seat #1 is the button
Seat 1: gabi6.10 ($4.19 in chips) 
Seat 2: Andreas Bich ($15.01 in chips) 
Seat 3: deRalf67 ($32.35 in chips) 
Seat 4: naymaierbra ($13.19 in chips) 
Seat 5: neopasnoo ($10.40 in chips) 
Seat 6: WI7ZZ ($12.57 in chips) 
Andreas Bich: posts small blind $0.05
deRalf67: posts big blind $0.10
*** HOLE CARDS ***
Dealt to WI7ZZ [7s Ad]
naymaierbra: folds 
neopasnoo: folds 
WI7ZZ: folds 
gabi6.10: folds 
Andreas Bich: raises $0.20 to $0.30
deRalf67: folds 
Uncalled bet ($0.20) returned to Andreas Bich
Andreas Bich collected $0.20 from pot
Andreas Bich: doesn't show hand 
*** SUMMARY ***
Total pot $0.20 | Rake $0 
Seat 1: gabi6.10 (button) folded before Flop (didn't bet)
Seat 2: Andreas Bich (small blind) collected ($0.20)
Seat 3: deRalf67 (big blind) folded before Flop
Seat 4: naymaierbra folded before Flop (didn't bet)
Seat 5: neopasnoo folded before Flop (didn't bet)
Seat 6: WI7ZZ folded before Flop (didn't bet)



PokerStars Zoom Hand #188749234429:  Hold'em No Limit ($0.05/$0.10) - 2018/07/15 14:04:50 WET [2018/07/15 9:04:50 ET]
Table 'Aludra' 6-max Seat #1 is the button
Seat 1: Pardaroxon ($11.52 in chips) 
Seat 2: SaneK*3dfX ($25.61 in chips) 
Seat 3: Radomir 26 ($10 in chips) 
Seat 4: WI7ZZ ($12.57 in chips) 
Seat 5: Kandidic ($20.22 in chips) 
Seat 6: anthony1480 ($5.01 in chips) 
SaneK*3dfX: posts small blind $0.05
Radomir 26: posts big blind $0.10
*** HOLE CARDS ***
Dealt to WI7ZZ [2c 4h]
WI7ZZ: folds 
Kandidic: folds 
anthony1480: folds 
Pardaroxon: raises $0.10 to $0.20
SaneK*3dfX: folds 
Radomir 26: folds 
Uncalled bet ($0.10) returned to Pardaroxon
Pardaroxon collected $0.25 from pot
Pardaroxon: doesn't show hand 
*** SUMMARY ***
Total pot $0.25 | Rake $0 
Seat 1: Pardaroxon (button) collected ($0.25)
Seat 2: SaneK*3dfX (small blind) folded before Flop
Seat 3: Radomir 26 (big blind) folded before Flop
Seat 4: WI7ZZ folded before Flop (didn't bet)
Seat 5: Kandidic folded before Flop (didn't bet)
Seat 6: anthony1480 folded before Flop (didn't bet)



PokerStars Zoom Hand #188749221821:  Hold'em No Limit ($0.05/$0.10) - 2018/07/15 14:04:25 WET [2018/07/15 9:04:25 ET]
Table 'Aludra' 6-max Seat #1 is the button
Seat 1: Jinxers ($19.40 in chips) 
Seat 2: mentaltony ($19.21 in chips) 
Seat 3: XXschmidtX ($14.03 in chips) 
Seat 4: rdleitao ($10 in chips) 
Seat 5: neopasnoo ($10.55 in chips) 
Seat 6: WI7ZZ ($12.67 in chips) 
mentaltony: posts small blind $0.05
XXschmidtX: posts big blind $0.10
*** HOLE CARDS ***
Dealt to WI7ZZ [Jc 5d]
rdleitao: folds 
neopasnoo: folds 
WI7ZZ: folds 
Jinxers: folds 
mentaltony: raises $0.20 to $0.30
XXschmidtX: calls $0.20
*** FLOP *** [2h Kd Qc]
mentaltony: checks 
XXschmidtX: bets $0.20
mentaltony: calls $0.20
*** TURN *** [2h Kd Qc] [Ad]
mentaltony: checks 
XXschmidtX: checks 
*** RIVER *** [2h Kd Qc Ad] [9h]
mentaltony: bets $0.70
XXschmidtX: folds 
Uncalled bet ($0.70) returned to mentaltony
mentaltony collected $0.96 from pot
mentaltony: doesn't show hand 
*** SUMMARY ***
Total pot $1 | Rake $0.04 
Board [2h Kd Qc Ad 9h]
Seat 1: Jinxers (button) folded before Flop (didn't bet)
Seat 2: mentaltony (small blind) collected ($0.96)
Seat 3: XXschmidtX (big blind) folded on the River
Seat 4: rdleitao folded before Flop (didn't bet)
Seat 5: neopasnoo folded before Flop (didn't bet)
Seat 6: WI7ZZ folded before Flop (didn't bet)



PokerStars Zoom Hand #188749237395:  Hold'em No Limit ($0.05/$0.10) - 2018/07/15 14:04:56 WET [2018/07/15 9:04:56 ET]
Table 'Aludra' 6-max Seat #1 is the button
Seat 1: 62MacDaddy ($9.39 in chips) 
Seat 2: WI7ZZ ($12.57 in chips) 
Seat 3: Spooks1337 ($25.65 in chips) 
Seat 4: Georgy21x ($8.54 in chips) 
Seat 5: hellf1re666 ($10 in chips) 
Seat 6: GuiBenites ($8.55 in chips) 
WI7ZZ: posts small blind $0.05
Spooks1337: posts big blind $0.10
*** HOLE CARDS ***
Dealt to WI7ZZ [Tc Ac]
Georgy21x has timed out
Georgy21x: folds 
hellf1re666: folds 
GuiBenites: raises $0.20 to $0.30
62MacDaddy: folds 
WI7ZZ: raises $0.60 to $0.90
Spooks1337: folds 
GuiBenites: calls $0.60
*** FLOP *** [3d Td As]
WI7ZZ: bets $0.80
GuiBenites: calls $0.80
*** TURN *** [3d Td As] [2s]
WI7ZZ: checks 
GuiBenites: bets $1.94
WI7ZZ: raises $3.18 to $5.12
GuiBenites: folds 
Uncalled bet ($3.18) returned to WI7ZZ
WI7ZZ collected $7.05 from pot
WI7ZZ: doesn't show hand 
*** SUMMARY ***
Total pot $7.38 | Rake $0.33 
Board [3d Td As 2s]
Seat 1: 62MacDaddy (button) folded before Flop (didn't bet)
Seat 2: WI7ZZ (small blind) collected ($7.05)
Seat 3: Spooks1337 (big blind) folded before Flop
Seat 4: Georgy21x folded before Flop (didn't bet)
Seat 5: hellf1re666 folded before Flop (didn't bet)
Seat 6: GuiBenites folded on the Turn



PokerStars Zoom Hand #188749265709:  Hold'em No Limit ($0.05/$0.10) - 2018/07/15 14:05:52 WET [2018/07/15 9:05:52 ET]
Table 'Aludra' 6-max Seat #1 is the button
Seat 1: libertcaus ($9.29 in chips) 
Seat 2: signofme ($16.07 in chips) 
Seat 3: coste2013 ($8.16 in chips) 
Seat 4: WI7ZZ ($15.98 in chips) 
Seat 5: kazyunok ($10.25 in chips) 
Seat 6: Andreas Bich ($13.39 in chips) 
signofme: posts small blind $0.05
coste2013: posts big blind $0.10
*** HOLE CARDS ***
Dealt to WI7ZZ [Td 8c]
WI7ZZ: folds 
kazyunok: folds 
Andreas Bich: folds 
libertcaus: folds 
signofme: folds 
Uncalled bet ($0.05) returned to coste2013
coste2013 collected $0.10 from pot
coste2013: doesn't show hand 
*** SUMMARY ***
Total pot $0.10 | Rake $0 
Seat 1: libertcaus (button) folded before Flop (didn't bet)
Seat 2: signofme (small blind) folded before Flop
Seat 3: coste2013 (big blind) collected ($0.10)
Seat 4: WI7ZZ folded before Flop (didn't bet)
Seat 5: kazyunok folded before Flop (didn't bet)
Seat 6: Andreas Bich folded before Flop (didn't bet)



PokerStars Zoom Hand #188749268296:  Hold'em No Limit ($0.05/$0.10) - 2018/07/15 14:05:57 WET [2018/07/15 9:05:57 ET]
Table 'Aludra' 6-max Seat #1 is the button
Seat 1: R2R2806 ($12.50 in chips) 
Seat 2: Gevron ($14.61 in chips) 
Seat 3: Dragonslyer1337 ($13.43 in chips) 
Seat 4: 5144336 ($7.43 in chips) 
Seat 5: WI7ZZ ($15.98 in chips) 
Seat 6: Jinxers ($19.66 in chips) 
Gevron: posts small blind $0.05
Dragonslyer1337: posts big blind $0.10
*** HOLE CARDS ***
Dealt to WI7ZZ [Ad Js]
5144336: raises $0.20 to $0.30
WI7ZZ: raises $0.60 to $0.90
Jinxers: folds 
R2R2806: folds 
Gevron: folds 
Dragonslyer1337: folds 
5144336: calls $0.60
*** FLOP *** [5h Ah As]
5144336: checks 
WI7ZZ: checks 
*** TURN *** [5h Ah As] [6d]
5144336: bets $0.50
WI7ZZ: raises $1.26 to $1.76
5144336: folds 
Uncalled bet ($1.26) returned to WI7ZZ
WI7ZZ collected $2.82 from pot
WI7ZZ: doesn't show hand 
*** SUMMARY ***
Total pot $2.95 | Rake $0.13 
Board [5h Ah As 6d]
Seat 1: R2R2806 (button) folded before Flop (didn't bet)
Seat 2: Gevron (small blind) folded before Flop
Seat 3: Dragonslyer1337 (big blind) folded before Flop
Seat 4: 5144336 folded on the Turn
Seat 5: WI7ZZ collected ($2.82)
Seat 6: Jinxers folded before Flop (didn't bet)



PokerStars Zoom Hand #188749267286:  Hold'em No Limit ($0.05/$0.10) - 2018/07/15 14:05:55 WET [2018/07/15 9:05:55 ET]
Table 'Aludra' 6-max Seat #1 is the button
Seat 1: WI7ZZ ($15.98 in chips) 
Seat 2: fajnywidok ($12.90 in chips) 
Seat 3: Dalibomba ($10 in chips) 
Seat 4: anthony1480 ($5.01 in chips) 
Seat 5: KartenBob0815 ($16.09 in chips) 
Seat 6: AgVolder ($15.61 in chips) 
fajnywidok: posts small blind $0.05
Dalibomba: posts big blind $0.10
*** HOLE CARDS ***
Dealt to WI7ZZ [Qc 7d]
anthony1480: folds 
KartenBob0815: folds 
AgVolder: folds 
WI7ZZ: folds 
fajnywidok has timed out
fajnywidok: folds 
Uncalled bet ($0.05) returned to Dalibomba
Dalibomba collected $0.10 from pot
Dalibomba: doesn't show hand 
*** SUMMARY ***
Total pot $0.10 | Rake $0 
Seat 1: WI7ZZ (button) folded before Flop (didn't bet)
Seat 2: fajnywidok (small blind) folded before Flop
Seat 3: Dalibomba (big blind) collected ($0.10)
Seat 4: anthony1480 folded before Flop (didn't bet)
Seat 5: KartenBob0815 folded before Flop (didn't bet)
Seat 6: AgVolder folded before Flop (didn't bet)



PokerStars Zoom Hand #188749293779:  Hold'em No Limit ($0.05/$0.10) - 2018/07/15 14:06:47 WET [2018/07/15 9:06:47 ET]
Table 'Aludra' 6-max Seat #1 is the button
Seat 1: m_carrillo89 ($14.12 in chips) 
Seat 2: WI7ZZ ($17.30 in chips) 
Seat 3: illejal ($10 in chips) 
Seat 4: edger4013 ($10.85 in chips) 
Seat 5: samurai ume ($10.65 in chips) 
Seat 6: ysha76 ($20.01 in chips) 
WI7ZZ: posts small blind $0.05
illejal: posts big blind $0.10
*** HOLE CARDS ***
Dealt to WI7ZZ [Td 3s]
edger4013: folds 
samurai ume: folds 
ysha76: folds 
m_carrillo89: raises $0.20 to $0.30
WI7ZZ: folds 
illejal: folds 
Uncalled bet ($0.20) returned to m_carrillo89
m_carrillo89 collected $0.25 from pot
m_carrillo89: doesn't show hand 
*** SUMMARY ***
Total pot $0.25 | Rake $0 
Seat 1: m_carrillo89 (button) collected ($0.25)
Seat 2: WI7ZZ (small blind) folded before Flop
Seat 3: illejal (big blind) folded before Flop
Seat 4: edger4013 folded before Flop (didn't bet)
Seat 5: samurai ume folded before Flop (didn't bet)
Seat 6: ysha76 folded before Flop (didn't bet)



PokerStars Zoom Hand #188749295275:  Hold'em No Limit ($0.05/$0.10) - 2018/07/15 14:06:50 WET [2018/07/15 9:06:50 ET]
Table 'Aludra' 6-max Seat #1 is the button
Seat 1: WI7ZZ ($17.25 in chips) 
Seat 2: SeaCloud1 ($9.22 in chips) 
Seat 3: coste2013 ($7.91 in chips) 
Seat 4: Vespao20 ($8.41 in chips) 
Seat 5: kl@kier ($10 in chips) 
Seat 6: hellf1re666 ($10 in chips) 
SeaCloud1: posts small blind $0.05
coste2013: posts big blind $0.10
*** HOLE CARDS ***
Dealt to WI7ZZ [Th 4s]
Vespao20: folds 
kl@kier: folds 
hellf1re666: raises $0.19 to $0.29
WI7ZZ: folds 
SeaCloud1: calls $0.24
coste2013: folds 
*** FLOP *** [Tc 8h 5s]
SeaCloud1: bets $0.10
hellf1re666: raises $0.49 to $0.59
SeaCloud1: calls $0.49
*** TURN *** [Tc 8h 5s] [8s]
SeaCloud1: bets $0.10
hellf1re666: folds 
Uncalled bet ($0.10) returned to SeaCloud1
SeaCloud1 collected $1.78 from pot
SeaCloud1: doesn't show hand 
*** SUMMARY ***
Total pot $1.86 | Rake $0.08 
Board [Tc 8h 5s 8s]
Seat 1: WI7ZZ (button) folded before Flop (didn't bet)
Seat 2: SeaCloud1 (small blind) collected ($1.78)
Seat 3: coste2013 (big blind) folded before Flop
Seat 4: Vespao20 folded before Flop (didn't bet)
Seat 5: kl@kier folded before Flop (didn't bet)
Seat 6: hellf1re666 folded on the Turn



PokerStars Zoom Hand #188749301393:  Hold'em No Limit ($0.05/$0.10) - 2018/07/15 14:07:02 WET [2018/07/15 9:07:02 ET]
Table 'Aludra' 6-max Seat #1 is the button
Seat 1: Foosball1980 ($10.91 in chips) 
Seat 2: tweeK1001 ($10.47 in chips) 
Seat 3: hansing81 ($10 in chips) 
Seat 4: WI7ZZ ($17.25 in chips) 
Seat 5: Pardaroxon ($16.07 in chips) 
Seat 6: Radomir 26 ($11.56 in chips) 
tweeK1001: posts small blind $0.05
hansing81: posts big blind $0.10
*** HOLE CARDS ***
Dealt to WI7ZZ [5s Kh]
WI7ZZ: folds 
Pardaroxon: folds 
Radomir 26: folds 
Foosball1980: folds 
tweeK1001: folds 
Uncalled bet ($0.05) returned to hansing81
hansing81 collected $0.10 from pot
hansing81: doesn't show hand 
*** SUMMARY ***
Total pot $0.10 | Rake $0 
Seat 1: Foosball1980 (button) folded before Flop (didn't bet)
Seat 2: tweeK1001 (small blind) folded before Flop
Seat 3: hansing81 (big blind) collected ($0.10)
Seat 4: WI7ZZ folded before Flop (didn't bet)
Seat 5: Pardaroxon folded before Flop (didn't bet)
Seat 6: Radomir 26 folded before Flop (didn't bet)



PokerStars Zoom Hand #188749290171:  Hold'em No Limit ($0.05/$0.10) - 2018/07/15 14:06:40 WET [2018/07/15 9:06:40 ET]
Table 'Aludra' 6-max Seat #1 is the button
Seat 1: illejal ($10 in chips) 
Seat 2: elWacki ($15.61 in chips) 
Seat 3: WI7ZZ ($17.40 in chips) 
Seat 4: mikitok ($11.46 in chips) 
Seat 5: Tamexo ($19 in chips) 
Seat 6: barcafan11 ($9.40 in chips) 
elWacki: posts small blind $0.05
WI7ZZ: posts big blind $0.10
*** HOLE CARDS ***
Dealt to WI7ZZ [5s Kh]
mikitok: raises $0.15 to $0.25
Tamexo: calls $0.25
barcafan11: folds 
illejal: folds 
elWacki: folds 
WI7ZZ: folds 
*** FLOP *** [Kc 2s Ad]
mikitok: bets $0.35
Tamexo: raises $0.35 to $0.70
mikitok: folds 
Uncalled bet ($0.35) returned to Tamexo
Tamexo collected $1.29 from pot
Tamexo: doesn't show hand 
*** SUMMARY ***
Total pot $1.35 | Rake $0.06 
Board [Kc 2s Ad]
Seat 1: illejal (button) folded before Flop (didn't bet)
Seat 2: elWacki (small blind) folded before Flop
Seat 3: WI7ZZ (big blind) folded before Flop
Seat 4: mikitok folded on the Flop
Seat 5: Tamexo collected ($1.29)
Seat 6: barcafan11 folded before Flop (didn't bet)



PokerStars Zoom Hand #188749299327:  Hold'em No Limit ($0.05/$0.10) - 2018/07/15 14:06:58 WET [2018/07/15 9:06:58 ET]
Table 'Aludra' 6-max Seat #1 is the button
Seat 1: youngteen ($10.53 in chips) 
Seat 2: louis0606 ($8.26 in chips) 
Seat 3: johnkanon13 ($17.42 in chips) 
Seat 4: Foosball1980 ($10.91 in chips) 
Seat 5: naymaierbra ($14.09 in chips) 
Seat 6: WI7ZZ ($17.25 in chips) 
louis0606: posts small blind $0.05
johnkanon13: posts big blind $0.10
*** HOLE CARDS ***
Dealt to WI7ZZ [3d 9s]
Foosball1980: folds 
naymaierbra: folds 
WI7ZZ: folds 
youngteen: folds 
louis0606: raises $0.11 to $0.21
johnkanon13: folds 
Uncalled bet ($0.11) returned to louis0606
louis0606 collected $0.20 from pot
louis0606: doesn't show hand 
*** SUMMARY ***
Total pot $0.20 | Rake $0 
Seat 1: youngteen (button) folded before Flop (didn't bet)
Seat 2: louis0606 (small blind) collected ($0.20)
Seat 3: johnkanon13 (big blind) folded before Flop
Seat 4: Foosball1980 folded before Flop (didn't bet)
Seat 5: naymaierbra folded before Flop (didn't bet)
Seat 6: WI7ZZ folded before Flop (didn't bet)



PokerStars Zoom Hand #188749296811:  Hold'em No Limit ($0.05/$0.10) - 2018/07/15 14:06:53 WET [2018/07/15 9:06:53 ET]
Table 'Aludra' 6-max Seat #1 is the button
Seat 1: H6U5r ($10.35 in chips) 
Seat 2: signofme ($11.23 in chips) 
Seat 3: kamikaza11 ($22 in chips) 
Seat 4: barcafan11 ($8.50 in chips) 
Seat 5: WI7ZZ ($17.25 in chips) 
Seat 6: Day Day Up6 ($24.68 in chips) 
signofme: posts small blind $0.05
kamikaza11: posts big blind $0.10
*** HOLE CARDS ***
Dealt to WI7ZZ [4s As]
barcafan11: raises $0.20 to $0.30
WI7ZZ: folds 
Day Day Up6: raises $0.60 to $0.90
H6U5r: folds 
signofme: folds 
kamikaza11: folds 
barcafan11: calls $0.60
*** FLOP *** [8c 4d 3h]
barcafan11: checks 
Day Day Up6: bets $1
barcafan11: folds 
Uncalled bet ($1) returned to Day Day Up6
Day Day Up6 collected $1.86 from pot
Day Day Up6: doesn't show hand 
*** SUMMARY ***
Total pot $1.95 | Rake $0.09 
Board [8c 4d 3h]
Seat 1: H6U5r (button) folded before Flop (didn't bet)
Seat 2: signofme (small blind) folded before Flop
Seat 3: kamikaza11 (big blind) folded before Flop
Seat 4: barcafan11 folded on the Flop
Seat 5: WI7ZZ folded before Flop (didn't bet)
Seat 6: Day Day Up6 collected ($1.86)



PokerStars Zoom Hand #188749303449:  Hold'em No Limit ($0.05/$0.10) - 2018/07/15 14:07:06 WET [2018/07/15 9:07:06 ET]
Table 'Aludra' 6-max Seat #1 is the button
Seat 1: Radomir 26 ($10.83 in chips) 
Seat 2: molis23 ($3.27 in chips) 
Seat 3: WI7ZZ ($17.25 in chips) 
Seat 4: IcePunishU ($48 in chips) 
Seat 5: kl@kier ($11.23 in chips) 
Seat 6: youngteen ($10.53 in chips) 
molis23: posts small blind $0.05
WI7ZZ: posts big blind $0.10
*** HOLE CARDS ***
Dealt to WI7ZZ [Tc Td]
IcePunishU: folds 
kl@kier: folds 
youngteen: folds 
Radomir 26: raises $0.10 to $0.20
molis23: folds 
WI7ZZ: raises $0.50 to $0.70
Radomir 26: calls $0.50
*** FLOP *** [2d Kd 6s]
WI7ZZ: bets $0.86
Radomir 26: calls $0.86
*** TURN *** [2d Kd 6s] [8s]
WI7ZZ: bets $1.40
Radomir 26: calls $1.40
*** RIVER *** [2d Kd 6s 8s] [3d]
WI7ZZ: checks 
Radomir 26: checks 
*** SHOW DOWN ***
WI7ZZ: shows [Tc Td] (a pair of Tens)
Radomir 26: mucks hand 
WI7ZZ collected $5.70 from pot
*** SUMMARY ***
Total pot $5.97 | Rake $0.27 
Board [2d Kd 6s 8s 3d]
Seat 1: Radomir 26 (button) mucked [2h Ah]
Seat 2: molis23 (small blind) folded before Flop
Seat 3: WI7ZZ (big blind) showed [Tc Td] and won ($5.70) with a pair of Tens
Seat 4: IcePunishU folded before Flop (didn't bet)
Seat 5: kl@kier folded before Flop (didn't bet)
Seat 6: youngteen folded before Flop (didn't bet)



PokerStars Zoom Hand #188749326703:  Hold'em No Limit ($0.05/$0.10) - 2018/07/15 14:07:51 WET [2018/07/15 9:07:51 ET]
Table 'Aludra' 6-max Seat #1 is the button
Seat 1: WI7ZZ ($19.99 in chips) 
Seat 2: GROM84 ($10.62 in chips) 
Seat 3: Sunrise1912 ($10.72 in chips) 
Seat 4: Bolk udachi ($16.64 in chips) 
Seat 5: Dan0505 ($5.06 in chips) 
Seat 6: Radomir 26 ($10 in chips) 
GROM84: posts small blind $0.05
Sunrise1912: posts big blind $0.10
*** HOLE CARDS ***
Dealt to WI7ZZ [4h Jd]
Bolk udachi: folds 
Dan0505: folds 
Radomir 26: folds 
WI7ZZ: folds 
GROM84: raises $0.15 to $0.25
Sunrise1912: folds 
Uncalled bet ($0.15) returned to GROM84
GROM84 collected $0.20 from pot
GROM84: doesn't show hand 
*** SUMMARY ***
Total pot $0.20 | Rake $0 
Seat 1: WI7ZZ (button) folded before Flop (didn't bet)
Seat 2: GROM84 (small blind) collected ($0.20)
Seat 3: Sunrise1912 (big blind) folded before Flop
Seat 4: Bolk udachi folded before Flop (didn't bet)
Seat 5: Dan0505 folded before Flop (didn't bet)
Seat 6: Radomir 26 folded before Flop (didn't bet)



PokerStars Zoom Hand #188749339057:  Hold'em No Limit ($0.05/$0.10) - 2018/07/15 14:08:15 WET [2018/07/15 9:08:15 ET]
Table 'Aludra' 6-max Seat #1 is the button
Seat 1: mentaltony ($10.89 in chips) 
Seat 2: hovlaa ($10 in chips) 
Seat 3: qqzan ($10.63 in chips) 
Seat 4: WI7ZZ ($19.94 in chips) 
Seat 5: fillette789 ($5.19 in chips) 
Seat 6: HolyOtti ($9.31 in chips) 
hovlaa: posts small blind $0.05
qqzan: posts big blind $0.10
*** HOLE CARDS ***
Dealt to WI7ZZ [6d 6c]
WI7ZZ: raises $0.16 to $0.26
fillette789: folds 
HolyOtti: folds 
mentaltony: folds 
hovlaa: folds 
qqzan: folds 
Uncalled bet ($0.16) returned to WI7ZZ
WI7ZZ collected $0.25 from pot
WI7ZZ: doesn't show hand 
*** SUMMARY ***
Total pot $0.25 | Rake $0 
Seat 1: mentaltony (button) folded before Flop (didn't bet)
Seat 2: hovlaa (small blind) folded before Flop
Seat 3: qqzan (big blind) folded before Flop
Seat 4: WI7ZZ collected ($0.25)
Seat 5: fillette789 folded before Flop (didn't bet)
Seat 6: HolyOtti folded before Flop (didn't bet)



PokerStars Zoom Hand #188749344365:  Hold'em No Limit ($0.05/$0.10) - 2018/07/15 14:08:25 WET [2018/07/15 9:08:25 ET]
Table 'Aludra' 6-max Seat #1 is the button
Seat 1: Hansestadt1910 ($38.12 in chips) 
Seat 2: MobileRack5 ($2.49 in chips) 
Seat 3: marian10049 ($13.20 in chips) 
Seat 4: indextown ($13.41 in chips) 
Seat 5: KartenBob0815 ($13.64 in chips) 
Seat 6: WI7ZZ ($20.09 in chips) 
MobileRack5: posts small blind $0.05
marian10049: posts big blind $0.10
*** HOLE CARDS ***
Dealt to WI7ZZ [Qd 7c]
indextown: folds 
KartenBob0815: folds 
WI7ZZ: folds 
Hansestadt1910: folds 
MobileRack5: folds 
Uncalled bet ($0.05) returned to marian10049
marian10049 collected $0.10 from pot
marian10049: doesn't show hand 
*** SUMMARY ***
Total pot $0.10 | Rake $0 
Seat 1: Hansestadt1910 (button) folded before Flop (didn't bet)
Seat 2: MobileRack5 (small blind) folded before Flop
Seat 3: marian10049 (big blind) collected ($0.10)
Seat 4: indextown folded before Flop (didn't bet)
Seat 5: KartenBob0815 folded before Flop (didn't bet)
Seat 6: WI7ZZ folded before Flop (didn't bet)



PokerStars Zoom Hand #188749346350:  Hold'em No Limit ($0.05/$0.10) - 2018/07/15 14:08:29 WET [2018/07/15 9:08:29 ET]
Table 'Aludra' 6-max Seat #1 is the button
Seat 1: Bolk udachi ($17.15 in chips) 
Seat 2: freeclimber6 ($17.75 in chips) 
Seat 3: KlausUwe91 ($2.85 in chips) 
Seat 4: MOU77Y ($10 in chips) 
Seat 5: WI7ZZ ($20.09 in chips) 
Seat 6: impulsivo ($13.43 in chips) 
freeclimber6: posts small blind $0.05
KlausUwe91: posts big blind $0.10
*** HOLE CARDS ***
Dealt to WI7ZZ [2d 5d]
MOU77Y: folds 
WI7ZZ: folds 
impulsivo: raises $0.20 to $0.30
Bolk udachi: folds 
freeclimber6: folds 
KlausUwe91: folds 
Uncalled bet ($0.20) returned to impulsivo
impulsivo collected $0.25 from pot
impulsivo: doesn't show hand 
*** SUMMARY ***
Total pot $0.25 | Rake $0 
Seat 1: Bolk udachi (button) folded before Flop (didn't bet)
Seat 2: freeclimber6 (small blind) folded before Flop
Seat 3: KlausUwe91 (big blind) folded before Flop
Seat 4: MOU77Y folded before Flop (didn't bet)
Seat 5: WI7ZZ folded before Flop (didn't bet)
Seat 6: impulsivo collected ($0.25)



PokerStars Zoom Hand #188749349426:  Hold'em No Limit ($0.05/$0.10) - 2018/07/15 14:08:35 WET [2018/07/15 9:08:35 ET]
Table 'Aludra' 6-max Seat #1 is the button
Seat 1: ancsa90 ($9.95 in chips) 
Seat 2: FULLFREEDOM ($4.14 in chips) 
Seat 3: WI7ZZ ($20.09 in chips) 
Seat 4: Cronus2013 ($11.22 in chips) 
Seat 5: Vespao20 ($9.78 in chips) 
Seat 6: Marsiz ($14.32 in chips) 
FULLFREEDOM: posts small blind $0.05
WI7ZZ: posts big blind $0.10
*** HOLE CARDS ***
Dealt to WI7ZZ [7c 4s]
Cronus2013: folds 
Vespao20: folds 
Marsiz: folds 
ancsa90: folds 
FULLFREEDOM: folds 
Uncalled bet ($0.05) returned to WI7ZZ
WI7ZZ collected $0.10 from pot
WI7ZZ: doesn't show hand 
*** SUMMARY ***
Total pot $0.10 | Rake $0 
Seat 1: ancsa90 (button) folded before Flop (didn't bet)
Seat 2: FULLFREEDOM (small blind) folded before Flop
Seat 3: WI7ZZ (big blind) collected ($0.10)
Seat 4: Cronus2013 folded before Flop (didn't bet)
Seat 5: Vespao20 folded before Flop (didn't bet)
Seat 6: Marsiz folded before Flop (didn't bet)



PokerStars Zoom Hand #188749358279:  Hold'em No Limit ($0.05/$0.10) - 2018/07/15 14:08:52 WET [2018/07/15 9:08:52 ET]
Table 'Aludra' 6-max Seat #1 is the button
Seat 1: mentaltony ($14.47 in chips) 
Seat 2: WI7ZZ ($20.14 in chips) 
Seat 3: ancsa90 ($9.95 in chips) 
Seat 4: IcePunishU ($17.16 in chips) 
Seat 5: Plevi1 ($14.85 in chips) 
Seat 6: maktuiu ($18.51 in chips) 
WI7ZZ: posts small blind $0.05
ancsa90: posts big blind $0.10
*** HOLE CARDS ***
Dealt to WI7ZZ [5d 3s]
IcePunishU: folds 
Plevi1: folds 
maktuiu: folds 
mentaltony: folds 
WI7ZZ: folds 
Uncalled bet ($0.05) returned to ancsa90
ancsa90 collected $0.10 from pot
ancsa90: doesn't show hand 
*** SUMMARY ***
Total pot $0.10 | Rake $0 
Seat 1: mentaltony (button) folded before Flop (didn't bet)
Seat 2: WI7ZZ (small blind) folded before Flop
Seat 3: ancsa90 (big blind) collected ($0.10)
Seat 4: IcePunishU folded before Flop (didn't bet)
Seat 5: Plevi1 folded before Flop (didn't bet)
Seat 6: maktuiu folded before Flop (didn't bet)



PokerStars Zoom Hand #188749359754:  Hold'em No Limit ($0.05/$0.10) - 2018/07/15 14:08:55 WET [2018/07/15 9:08:55 ET]
Table 'Aludra' 6-max Seat #1 is the button
Seat 1: WI7ZZ ($20.09 in chips) 
Seat 2: mihalis_5555 ($9.89 in chips) 
Seat 3: IcePunishU ($17.16 in chips) 
Seat 4: Sunrise1912 ($10.32 in chips) 
Seat 5: Hansestadt1910 ($38.12 in chips) 
Seat 6: hellf1re666 ($10.41 in chips) 
mihalis_5555: posts small blind $0.05
IcePunishU: posts big blind $0.10
*** HOLE CARDS ***
Dealt to WI7ZZ [3c 7h]
Sunrise1912: folds 
Hansestadt1910: folds 
hellf1re666: folds 
WI7ZZ: folds 
mihalis_5555: folds 
Uncalled bet ($0.05) returned to IcePunishU
IcePunishU collected $0.10 from pot
IcePunishU: doesn't show hand 
*** SUMMARY ***
Total pot $0.10 | Rake $0 
Seat 1: WI7ZZ (button) folded before Flop (didn't bet)
Seat 2: mihalis_5555 (small blind) folded before Flop
Seat 3: IcePunishU (big blind) collected ($0.10)
Seat 4: Sunrise1912 folded before Flop (didn't bet)
Seat 5: Hansestadt1910 folded before Flop (didn't bet)
Seat 6: hellf1re666 folded before Flop (didn't bet)



PokerStars Zoom Hand #188749330835:  Hold'em No Limit ($0.05/$0.10) - 2018/07/15 14:07:59 WET [2018/07/15 9:07:59 ET]
Table 'Aludra' 6-max Seat #1 is the button
Seat 1: ivanrada ($25.26 in chips) 
Seat 2: WI7ZZ ($19.99 in chips) 
Seat 3: signofme ($12.25 in chips) 
Seat 4: Day Day Up6 ($24.32 in chips) 
Seat 5: Dalibomba ($10.87 in chips) 
Seat 6: WhiteDAGLeki ($10 in chips) 
WI7ZZ: posts small blind $0.05
signofme: posts big blind $0.10
*** HOLE CARDS ***
Dealt to WI7ZZ [7h Ac]
Day Day Up6: folds 
Dalibomba: raises $0.13 to $0.23
WhiteDAGLeki: calls $0.23
ivanrada: folds 
WI7ZZ: folds 
signofme: calls $0.13
*** FLOP *** [8c 2s 7s]
signofme: checks 
Dalibomba: checks 
WhiteDAGLeki: checks 
*** TURN *** [8c 2s 7s] [6d]
signofme: checks 
Dalibomba: checks 
WhiteDAGLeki: checks 
*** RIVER *** [8c 2s 7s 6d] [Tc]
signofme: checks 
Dalibomba: checks 
WhiteDAGLeki: checks 
*** SHOW DOWN ***
signofme: shows [Qc Jc] (high card Queen)
Dalibomba: shows [Ad Qh] (high card Ace)
WhiteDAGLeki: mucks hand 
Dalibomba collected $0.71 from pot
*** SUMMARY ***
Total pot $0.74 | Rake $0.03 
Board [8c 2s 7s 6d Tc]
Seat 1: ivanrada (button) folded before Flop (didn't bet)
Seat 2: WI7ZZ (small blind) folded before Flop
Seat 3: signofme (big blind) showed [Qc Jc] and lost with high card Queen
Seat 4: Day Day Up6 folded before Flop (didn't bet)
Seat 5: Dalibomba showed [Ad Qh] and won ($0.71) with high card Ace
Seat 6: WhiteDAGLeki mucked [Qs Jd]



PokerStars Zoom Hand #188749361298:  Hold'em No Limit ($0.05/$0.10) - 2018/07/15 14:08:58 WET [2018/07/15 9:08:58 ET]
Table 'Aludra' 6-max Seat #1 is the button
Seat 1: DIUK33 ($10 in chips) 
Seat 2: KingS3v3n ($9.27 in chips) 
Seat 3: kyle25156556 ($5.25 in chips) 
Seat 4: WI7ZZ ($20.09 in chips) 
Seat 5: actionMoon ($10 in chips) 
Seat 6: ValiumJJ ($30.92 in chips) 
KingS3v3n: posts small blind $0.05
kyle25156556: posts big blind $0.10
*** HOLE CARDS ***
Dealt to WI7ZZ [Td Qd]
WI7ZZ: raises $0.26 to $0.36
actionMoon: folds 
ValiumJJ: folds 
DIUK33: folds 
KingS3v3n: folds 
kyle25156556: calls $0.26
*** FLOP *** [Kh Kc 7d]
kyle25156556: checks 
WI7ZZ: bets $0.28
kyle25156556: calls $0.28
*** TURN *** [Kh Kc 7d] [As]
kyle25156556: checks 
WI7ZZ: checks 
*** RIVER *** [Kh Kc 7d As] [7s]
kyle25156556: bets $0.64
WI7ZZ: folds 
Uncalled bet ($0.64) returned to kyle25156556
kyle25156556 collected $1.27 from pot
*** SUMMARY ***
Total pot $1.33 | Rake $0.06 
Board [Kh Kc 7d As 7s]
Seat 1: DIUK33 (button) folded before Flop (didn't bet)
Seat 2: KingS3v3n (small blind) folded before Flop
Seat 3: kyle25156556 (big blind) collected ($1.27)
Seat 4: WI7ZZ folded on the River
Seat 5: actionMoon folded before Flop (didn't bet)
Seat 6: ValiumJJ folded before Flop (didn't bet)



PokerStars Zoom Hand #188749386103:  Hold'em No Limit ($0.05/$0.10) - 2018/07/15 14:09:46 WET [2018/07/15 9:09:46 ET]
Table 'Aludra' 6-max Seat #1 is the button
Seat 1: yk_rf_22 ($6.44 in chips) 
Seat 2: Pardaroxon ($10 in chips) 
Seat 3: Dragonslyer1337 ($13.89 in chips) 
Seat 4: signofme ($11.97 in chips) 
Seat 5: redsy22 ($24.07 in chips) 
Seat 6: WI7ZZ ($19.45 in chips) 
Pardaroxon: posts small blind $0.05
Dragonslyer1337: posts big blind $0.10
*** HOLE CARDS ***
Dealt to WI7ZZ [Th 9c]
signofme: folds 
redsy22: raises $0.20 to $0.30
WI7ZZ: folds 
yk_rf_22: calls $0.30
Pardaroxon: folds 
Dragonslyer1337: folds 
*** FLOP *** [8c Tc Kh]
redsy22: checks 
yk_rf_22: checks 
*** TURN *** [8c Tc Kh] [2h]
redsy22: checks 
yk_rf_22: checks 
*** RIVER *** [8c Tc Kh 2h] [8h]
redsy22: checks 
yk_rf_22: checks 
*** SHOW DOWN ***
redsy22: shows [7c 7s] (two pair, Eights and Sevens)
yk_rf_22: mucks hand 
redsy22 collected $0.72 from pot
*** SUMMARY ***
Total pot $0.75 | Rake $0.03 
Board [8c Tc Kh 2h 8h]
Seat 1: yk_rf_22 (button) mucked [6c As]
Seat 2: Pardaroxon (small blind) folded before Flop
Seat 3: Dragonslyer1337 (big blind) folded before Flop
Seat 4: signofme folded before Flop (didn't bet)
Seat 5: redsy22 showed [7c 7s] and won ($0.72) with two pair, Eights and Sevens
Seat 6: WI7ZZ folded before Flop (didn't bet)



PokerStars Zoom Hand #188749384589:  Hold'em No Limit ($0.05/$0.10) - 2018/07/15 14:09:43 WET [2018/07/15 9:09:43 ET]
Table 'Aludra' 6-max Seat #1 is the button
Seat 1: Toxa512 ($22.89 in chips) 
Seat 2: niqqa48 ($14.71 in chips) 
Seat 3: Eregne ($10.58 in chips) 
Seat 4: WI7ZZ ($19.45 in chips) 
Seat 5: hastyboots ($10.32 in chips) 
Seat 6: pushi2 ($11.62 in chips) 
niqqa48: posts small blind $0.05
Eregne: posts big blind $0.10
*** HOLE CARDS ***
Dealt to WI7ZZ [3s 9d]
WI7ZZ: folds 
hastyboots: raises $0.15 to $0.25
pushi2: folds 
Toxa512: folds 
niqqa48: raises $0.75 to $1
Eregne: folds 
hastyboots: raises $1.40 to $2.40
niqqa48: folds 
Uncalled bet ($1.40) returned to hastyboots
hastyboots collected $2.10 from pot
hastyboots: doesn't show hand 
*** SUMMARY ***
Total pot $2.10 | Rake $0 
Seat 1: Toxa512 (button) folded before Flop (didn't bet)
Seat 2: niqqa48 (small blind) folded before Flop
Seat 3: Eregne (big blind) folded before Flop
Seat 4: WI7ZZ folded before Flop (didn't bet)
Seat 5: hastyboots collected ($2.10)
Seat 6: pushi2 folded before Flop (didn't bet)



PokerStars Zoom Hand #188749404993:  Hold'em No Limit ($0.05/$0.10) - 2018/07/15 14:10:23 WET [2018/07/15 9:10:23 ET]
Table 'Aludra' 6-max Seat #1 is the button
Seat 1: QuakieMan ($14.26 in chips) 
Seat 2: Bravarian ($8.82 in chips) 
Seat 3: WI7ZZ ($19.45 in chips) 
Seat 4: Aarons AA ($19.68 in chips) 
Seat 5: ferrari0303 ($4.02 in chips) 
Seat 6: actionMoon ($10 in chips) 
Bravarian: posts small blind $0.05
WI7ZZ: posts big blind $0.10
*** HOLE CARDS ***
Dealt to WI7ZZ [Kd 9h]
Aarons AA: folds 
ferrari0303: raises $0.10 to $0.20
actionMoon: folds 
QuakieMan: calls $0.20
Bravarian: folds 
WI7ZZ: calls $0.10
*** FLOP *** [2d Qc As]
WI7ZZ: checks 
ferrari0303: bets $0.50
QuakieMan: folds 
WI7ZZ: folds 
Uncalled bet ($0.50) returned to ferrari0303
ferrari0303 collected $0.62 from pot
ferrari0303: doesn't show hand 
*** SUMMARY ***
Total pot $0.65 | Rake $0.03 
Board [2d Qc As]
Seat 1: QuakieMan (button) folded on the Flop
Seat 2: Bravarian (small blind) folded before Flop
Seat 3: WI7ZZ (big blind) folded on the Flop
Seat 4: Aarons AA folded before Flop (didn't bet)
Seat 5: ferrari0303 collected ($0.62)
Seat 6: actionMoon folded before Flop (didn't bet)



PokerStars Zoom Hand #188749417471:  Hold'em No Limit ($0.05/$0.10) - 2018/07/15 14:10:47 WET [2018/07/15 9:10:47 ET]
Table 'Aludra' 6-max Seat #1 is the button
Seat 1: lordx777 ($10 in chips) 
Seat 2: ancsa90 ($9.70 in chips) 
Seat 3: edger4013 ($10 in chips) 
Seat 4: michaltoja ($13.58 in chips) 
Seat 5: deRalf67 ($31.89 in chips) 
Seat 6: WI7ZZ ($19.20 in chips) 
ancsa90: posts small blind $0.05
edger4013: posts big blind $0.10
*** HOLE CARDS ***
Dealt to WI7ZZ [7h 3s]
michaltoja: folds 
deRalf67: folds 
WI7ZZ: folds 
lordx777: folds 
ancsa90: folds 
Uncalled bet ($0.05) returned to edger4013
edger4013 collected $0.10 from pot
edger4013: doesn't show hand 
*** SUMMARY ***
Total pot $0.10 | Rake $0 
Seat 1: lordx777 (button) folded before Flop (didn't bet)
Seat 2: ancsa90 (small blind) folded before Flop
Seat 3: edger4013 (big blind) collected ($0.10)
Seat 4: michaltoja folded before Flop (didn't bet)
Seat 5: deRalf67 folded before Flop (didn't bet)
Seat 6: WI7ZZ folded before Flop (didn't bet)



PokerStars Zoom Hand #188749418997:  Hold'em No Limit ($0.05/$0.10) - 2018/07/15 14:10:50 WET [2018/07/15 9:10:50 ET]
Table 'Aludra' 6-max Seat #1 is the button
Seat 1: WI7ZZ ($19.20 in chips) 
Seat 2: anthony1480 ($5 in chips) 
Seat 3: Sunrise1912 ($10.40 in chips) 
Seat 4: AloneWithU ($10 in chips) 
Seat 5: ultra radi ($14.41 in chips) 
Seat 6: WhiteDAGLeki ($10.30 in chips) 
anthony1480: posts small blind $0.05
Sunrise1912: posts big blind $0.10
*** HOLE CARDS ***
Dealt to WI7ZZ [9s 7c]
AloneWithU: folds 
ultra radi: folds 
WhiteDAGLeki: folds 
WI7ZZ: folds 
anthony1480: folds 
Uncalled bet ($0.05) returned to Sunrise1912
Sunrise1912 collected $0.10 from pot
Sunrise1912: doesn't show hand 
*** SUMMARY ***
Total pot $0.10 | Rake $0 
Seat 1: WI7ZZ (button) folded before Flop (didn't bet)
Seat 2: anthony1480 (small blind) folded before Flop
Seat 3: Sunrise1912 (big blind) collected ($0.10)
Seat 4: AloneWithU folded before Flop (didn't bet)
Seat 5: ultra radi folded before Flop (didn't bet)
Seat 6: WhiteDAGLeki folded before Flop (didn't bet)



PokerStars Zoom Hand #188749415961:  Hold'em No Limit ($0.05/$0.10) - 2018/07/15 14:10:44 WET [2018/07/15 9:10:44 ET]
Table 'Aludra' 6-max Seat #1 is the button
Seat 1: m_carrillo89 ($10.15 in chips) 
Seat 2: WI7ZZ ($19.25 in chips) 
Seat 3: -=l Grek l=- ($15.40 in chips) 
Seat 4: knullig ($8.10 in chips) 
Seat 5: R0MMMAN ($10.19 in chips) 
Seat 6: Day Day Up6 ($25.47 in chips) 
WI7ZZ: posts small blind $0.05
-=l Grek l=-: posts big blind $0.10
*** HOLE CARDS ***
Dealt to WI7ZZ [Qs 5s]
knullig: folds 
R0MMMAN: folds 
Day Day Up6: folds 
m_carrillo89: folds 
WI7ZZ: folds 
Uncalled bet ($0.05) returned to -=l Grek l=-
-=l Grek l=- collected $0.10 from pot
-=l Grek l=-: doesn't show hand 
*** SUMMARY ***
Total pot $0.10 | Rake $0 
Seat 1: m_carrillo89 (button) folded before Flop (didn't bet)
Seat 2: WI7ZZ (small blind) folded before Flop
Seat 3: -=l Grek l=- (big blind) collected ($0.10)
Seat 4: knullig folded before Flop (didn't bet)
Seat 5: R0MMMAN folded before Flop (didn't bet)
Seat 6: Day Day Up6 folded before Flop (didn't bet)



PokerStars Zoom Hand #188749421037:  Hold'em No Limit ($0.05/$0.10) - 2018/07/15 14:10:54 WET [2018/07/15 9:10:54 ET]
Table 'Aludra' 6-max Seat #1 is the button
Seat 1: mentaltony ($10.08 in chips) 
Seat 2: cip1001t ($8.43 in chips) 
Seat 3: Dalibomba ($11.37 in chips) 
Seat 4: WhiteDAGLeki ($10.30 in chips) 
Seat 5: WI7ZZ ($19.20 in chips) 
Seat 6: andremgremio ($12.14 in chips) 
cip1001t: posts small blind $0.05
Dalibomba: posts big blind $0.10
*** HOLE CARDS ***
Dealt to WI7ZZ [As 9c]
WhiteDAGLeki: folds 
WI7ZZ: raises $0.16 to $0.26
andremgremio: folds 
mentaltony: calls $0.26
cip1001t: folds 
Dalibomba: folds 
*** FLOP *** [9h 9s 8s]
WI7ZZ: bets $0.28
mentaltony: folds 
Uncalled bet ($0.28) returned to WI7ZZ
WI7ZZ collected $0.64 from pot
WI7ZZ: doesn't show hand 
*** SUMMARY ***
Total pot $0.67 | Rake $0.03 
Board [9h 9s 8s]
Seat 1: mentaltony (button) folded on the Flop
Seat 2: cip1001t (small blind) folded before Flop
Seat 3: Dalibomba (big blind) folded before Flop
Seat 4: WhiteDAGLeki folded before Flop (didn't bet)
Seat 5: WI7ZZ collected ($0.64)
Seat 6: andremgremio folded before Flop (didn't bet)



PokerStars Zoom Hand #188749434985:  Hold'em No Limit ($0.05/$0.10) - 2018/07/15 14:11:21 WET [2018/07/15 9:11:21 ET]
Table 'Aludra' 6-max Seat #1 is the button
Seat 1: -=l Grek l=- ($15.45 in chips) 
Seat 2: WI7ZZ ($19.58 in chips) 
Seat 3: edelnuss1 ($10 in chips) 
Seat 4: ChungkingExp ($10 in chips) 
Seat 5: TestaDiCazz ($10.15 in chips) 
Seat 6: donghatimpy ($10 in chips) 
WI7ZZ: posts small blind $0.05
edelnuss1: posts big blind $0.10
*** HOLE CARDS ***
Dealt to WI7ZZ [Kh 8c]
ChungkingExp: folds 
TestaDiCazz: folds 
donghatimpy: folds 
-=l Grek l=-: folds 
WI7ZZ: raises $0.16 to $0.26
edelnuss1: calls $0.16
*** FLOP *** [2s Ks 9s]
WI7ZZ: bets $0.31
edelnuss1: folds 
Uncalled bet ($0.31) returned to WI7ZZ
WI7ZZ collected $0.50 from pot
WI7ZZ: doesn't show hand 
*** SUMMARY ***
Total pot $0.52 | Rake $0.02 
Board [2s Ks 9s]
Seat 1: -=l Grek l=- (button) folded before Flop (didn't bet)
Seat 2: WI7ZZ (small blind) collected ($0.50)
Seat 3: edelnuss1 (big blind) folded on the Flop
Seat 4: ChungkingExp folded before Flop (didn't bet)
Seat 5: TestaDiCazz folded before Flop (didn't bet)
Seat 6: donghatimpy folded before Flop (didn't bet)



PokerStars Zoom Hand #188749449310:  Hold'em No Limit ($0.05/$0.10) - 2018/07/15 14:11:49 WET [2018/07/15 9:11:49 ET]
Table 'Aludra' 6-max Seat #1 is the button
Seat 1: AnHoCa ($11.58 in chips) 
Seat 2: youngteen ($10 in chips) 
Seat 3: WI7ZZ ($19.82 in chips) 
Seat 4: CafeDay ($10 in chips) 
Seat 5: Herr Wissert ($12.58 in chips) 
Seat 6: M.Hakk1nen ($19.05 in chips) 
youngteen: posts small blind $0.05
WI7ZZ: posts big blind $0.10
*** HOLE CARDS ***
Dealt to WI7ZZ [4c Jd]
CafeDay: folds 
Herr Wissert: folds 
M.Hakk1nen: folds 
AnHoCa: folds 
youngteen: folds 
Uncalled bet ($0.05) returned to WI7ZZ
WI7ZZ collected $0.10 from pot
WI7ZZ: doesn't show hand 
*** SUMMARY ***
Total pot $0.10 | Rake $0 
Seat 1: AnHoCa (button) folded before Flop (didn't bet)
Seat 2: youngteen (small blind) folded before Flop
Seat 3: WI7ZZ (big blind) collected ($0.10)
Seat 4: CafeDay folded before Flop (didn't bet)
Seat 5: Herr Wissert folded before Flop (didn't bet)
Seat 6: M.Hakk1nen folded before Flop (didn't bet)



PokerStars Zoom Hand #188749458251:  Hold'em No Limit ($0.05/$0.10) - 2018/07/15 14:12:06 WET [2018/07/15 9:12:06 ET]
Table 'Aludra' 6-max Seat #1 is the button
Seat 1: dzoint ($10.67 in chips) 
Seat 2: Bravarian ($7.77 in chips) 
Seat 3: PollyPeachum ($10.40 in chips) 
Seat 4: WI7ZZ ($19.87 in chips) 
Seat 5: DIUK33 ($10.85 in chips) 
Seat 6: yk_rf_22 ($8.94 in chips) 
Bravarian: posts small blind $0.05
PollyPeachum: posts big blind $0.10
*** HOLE CARDS ***
Dealt to WI7ZZ [5h 5c]
WI7ZZ: folds 
DIUK33: folds 
yk_rf_22: folds 
dzoint: raises $0.15 to $0.25
Bravarian: folds 
PollyPeachum: folds 
Uncalled bet ($0.15) returned to dzoint
dzoint collected $0.25 from pot
dzoint: doesn't show hand 
*** SUMMARY ***
Total pot $0.25 | Rake $0 
Seat 1: dzoint (button) collected ($0.25)
Seat 2: Bravarian (small blind) folded before Flop
Seat 3: PollyPeachum (big blind) folded before Flop
Seat 4: WI7ZZ folded before Flop (didn't bet)
Seat 5: DIUK33 folded before Flop (didn't bet)
Seat 6: yk_rf_22 folded before Flop (didn't bet)



PokerStars Zoom Hand #188749459737:  Hold'em No Limit ($0.05/$0.10) - 2018/07/15 14:12:09 WET [2018/07/15 9:12:09 ET]
Table 'Aludra' 6-max Seat #1 is the button
Seat 1: WI7ZZ ($19.87 in chips) 
Seat 2: MOU77Y ($10.66 in chips) 
Seat 3: Lascher1976 ($16.31 in chips) 
Seat 4: Jinxers ($21.77 in chips) 
Seat 5: ChungkingExp ($10.26 in chips) 
Seat 6: louis0606 ($9.03 in chips) 
MOU77Y: posts small blind $0.05
Lascher1976: posts big blind $0.10
*** HOLE CARDS ***
Dealt to WI7ZZ [9d Ad]
Jinxers: folds 
ChungkingExp: folds 
louis0606: folds 
WI7ZZ: raises $0.21 to $0.31
MOU77Y: folds 
Lascher1976: folds 
Uncalled bet ($0.21) returned to WI7ZZ
WI7ZZ collected $0.25 from pot
WI7ZZ: doesn't show hand 
*** SUMMARY ***
Total pot $0.25 | Rake $0 
Seat 1: WI7ZZ (button) collected ($0.25)
Seat 2: MOU77Y (small blind) folded before Flop
Seat 3: Lascher1976 (big blind) folded before Flop
Seat 4: Jinxers folded before Flop (didn't bet)
Seat 5: ChungkingExp folded before Flop (didn't bet)
Seat 6: louis0606 folded before Flop (didn't bet)



PokerStars Zoom Hand #188749471617:  Hold'em No Limit ($0.05/$0.10) - 2018/07/15 14:12:32 WET [2018/07/15 9:12:32 ET]
Table 'Aludra' 6-max Seat #1 is the button
Seat 1: Afrykanka ($9.61 in chips) 
Seat 2: Gevron ($31.43 in chips) 
Seat 3: Frogrod ($10 in chips) 
Seat 4: universe123 ($8.70 in chips) 
Seat 5: WI7ZZ ($20.02 in chips) 
Seat 6: tamori14 ($13.39 in chips) 
Gevron: posts small blind $0.05
Frogrod: posts big blind $0.10
*** HOLE CARDS ***
Dealt to WI7ZZ [Jd Jc]
universe123: folds 
WI7ZZ: raises $0.21 to $0.31
tamori14: folds 
Afrykanka: calls $0.31
Gevron: folds 
Frogrod: folds 
*** FLOP *** [Js Ts Ah]
WI7ZZ: bets $0.46
Afrykanka: raises $1 to $1.46
WI7ZZ: raises $2.19 to $3.65
Afrykanka: raises $5.65 to $9.30 and is all-in
WI7ZZ: calls $5.65
*** TURN *** [Js Ts Ah] [Qh]
*** RIVER *** [Js Ts Ah Qh] [2s]
*** SHOW DOWN ***
WI7ZZ: shows [Jd Jc] (three of a kind, Jacks)
Afrykanka: shows [Ks Ac] (a straight, Ten to Ace)
Afrykanka collected $18.50 from pot
*** SUMMARY ***
Total pot $19.37 | Rake $0.87 
Board [Js Ts Ah Qh 2s]
Seat 1: Afrykanka (button) showed [Ks Ac] and won ($18.50) with a straight, Ten to Ace
Seat 2: Gevron (small blind) folded before Flop
Seat 3: Frogrod (big blind) folded before Flop
Seat 4: universe123 folded before Flop (didn't bet)
Seat 5: WI7ZZ showed [Jd Jc] and lost with three of a kind, Jacks
Seat 6: tamori14 folded before Flop (didn't bet)



PokerStars Zoom Hand #188749501500:  Hold'em No Limit ($0.05/$0.10) - 2018/07/15 14:13:30 WET [2018/07/15 9:13:30 ET]
Table 'Aludra' 6-max Seat #1 is the button
Seat 1: Predtecha87 ($11.56 in chips) 
Seat 2: jb112358 ($12.21 in chips) 
Seat 3: andypr0 ($10 in chips) 
Seat 4: drunya1968 ($29.56 in chips) 
Seat 5: moneyAAces ($9.85 in chips) 
Seat 6: WI7ZZ ($10.41 in chips) 
jb112358: posts small blind $0.05
andypr0: posts big blind $0.10
*** HOLE CARDS ***
Dealt to WI7ZZ [Ac 9c]
drunya1968: folds 
moneyAAces: folds 
WI7ZZ: raises $0.21 to $0.31
Predtecha87: folds 
jb112358: calls $0.26
andypr0: folds 
*** FLOP *** [Ad 6c Qs]
jb112358: checks 
WI7ZZ: bets $0.43
jb112358: folds 
Uncalled bet ($0.43) returned to WI7ZZ
WI7ZZ collected $0.69 from pot
WI7ZZ: doesn't show hand 
*** SUMMARY ***
Total pot $0.72 | Rake $0.03 
Board [Ad 6c Qs]
Seat 1: Predtecha87 (button) folded before Flop (didn't bet)
Seat 2: jb112358 (small blind) folded on the Flop
Seat 3: andypr0 (big blind) folded before Flop
Seat 4: drunya1968 folded before Flop (didn't bet)
Seat 5: moneyAAces folded before Flop (didn't bet)
Seat 6: WI7ZZ collected ($0.69)



PokerStars Zoom Hand #188749512765:  Hold'em No Limit ($0.05/$0.10) - 2018/07/15 14:13:52 WET [2018/07/15 9:13:52 ET]
Table 'Aludra' 6-max Seat #1 is the button
Seat 1: M.Hakk1nen ($23.12 in chips) 
Seat 2: hovlaa ($10.32 in chips) 
Seat 3: WI7ZZ ($10.79 in chips) 
Seat 4: andypr0 ($10 in chips) 
Seat 5: mentaltony ($9.55 in chips) 
Seat 6: Totosha333 ($10.37 in chips) 
hovlaa: posts small blind $0.05
WI7ZZ: posts big blind $0.10
*** HOLE CARDS ***
Dealt to WI7ZZ [Tc 6c]
andypr0: raises $0.20 to $0.30
mentaltony: folds 
Totosha333: folds 
M.Hakk1nen: folds 
hovlaa: folds 
WI7ZZ: folds 
Uncalled bet ($0.20) returned to andypr0
andypr0 collected $0.25 from pot
andypr0: doesn't show hand 
*** SUMMARY ***
Total pot $0.25 | Rake $0 
Seat 1: M.Hakk1nen (button) folded before Flop (didn't bet)
Seat 2: hovlaa (small blind) folded before Flop
Seat 3: WI7ZZ (big blind) folded before Flop
Seat 4: andypr0 collected ($0.25)
Seat 5: mentaltony folded before Flop (didn't bet)
Seat 6: Totosha333 folded before Flop (didn't bet)



PokerStars Zoom Hand #188749543671:  Hold'em No Limit ($0.05/$0.10) - 2018/07/15 14:14:52 WET [2018/07/15 9:14:52 ET]
Table 'Aludra' 6-max Seat #1 is the button
Seat 1: youngteen ($10 in chips) 
Seat 2: niqqa48 ($27.81 in chips) 
Seat 3: illuvatar125 ($16.26 in chips) 
Seat 4: WI7ZZ ($10.69 in chips) 
Seat 5: naymaierbra ($10 in chips) 
Seat 6: Predtecha87 ($10 in chips) 
niqqa48: posts small blind $0.05
illuvatar125: posts big blind $0.10
*** HOLE CARDS ***
Dealt to WI7ZZ [3h 8c]
WI7ZZ: folds 
naymaierbra: folds 
Predtecha87: raises $0.20 to $0.30
youngteen: folds 
niqqa48: folds 
illuvatar125: folds 
Uncalled bet ($0.20) returned to Predtecha87
Predtecha87 collected $0.25 from pot
Predtecha87: doesn't show hand 
*** SUMMARY ***
Total pot $0.25 | Rake $0 
Seat 1: youngteen (button) folded before Flop (didn't bet)
Seat 2: niqqa48 (small blind) folded before Flop
Seat 3: illuvatar125 (big blind) folded before Flop
Seat 4: WI7ZZ folded before Flop (didn't bet)
Seat 5: naymaierbra folded before Flop (didn't bet)
Seat 6: Predtecha87 collected ($0.25)



PokerStars Zoom Hand #188749546777:  Hold'em No Limit ($0.05/$0.10) - 2018/07/15 14:14:58 WET [2018/07/15 9:14:58 ET]
Table 'Aludra' 6-max Seat #1 is the button
Seat 1: jinn171700 ($9.85 in chips) 
Seat 2: WI7ZZ ($10.69 in chips) 
Seat 3: FULLFREEDOM ($3.68 in chips) 
Seat 4: Jinxers ($22.31 in chips) 
Seat 5: naymaierbra ($10 in chips) 
Seat 6: TestaDiCazz ($10.11 in chips) 
WI7ZZ: posts small blind $0.05
FULLFREEDOM: posts big blind $0.10
*** HOLE CARDS ***
Dealt to WI7ZZ [Tc 5c]
Jinxers: folds 
naymaierbra: raises $0.20 to $0.30
TestaDiCazz: folds 
jinn171700: folds 
WI7ZZ: folds 
FULLFREEDOM: folds 
Uncalled bet ($0.20) returned to naymaierbra
naymaierbra collected $0.25 from pot
naymaierbra: doesn't show hand 
*** SUMMARY ***
Total pot $0.25 | Rake $0 
Seat 1: jinn171700 (button) folded before Flop (didn't bet)
Seat 2: WI7ZZ (small blind) folded before Flop
Seat 3: FULLFREEDOM (big blind) folded before Flop
Seat 4: Jinxers folded before Flop (didn't bet)
Seat 5: naymaierbra collected ($0.25)
Seat 6: TestaDiCazz folded before Flop (didn't bet)



PokerStars Zoom Hand #188749548367:  Hold'em No Limit ($0.05/$0.10) - 2018/07/15 14:15:01 WET [2018/07/15 9:15:01 ET]
Table 'Aludra' 6-max Seat #1 is the button
Seat 1: Foosball1980 ($10 in chips) 
Seat 2: louis0606 ($10.03 in chips) 
Seat 3: Aarons AA ($19.01 in chips) 
Seat 4: WI7ZZ ($10.64 in chips) 
Seat 5: M.Hakk1nen ($11.46 in chips) 
Seat 6: KartenBob0815 ($16.64 in chips) 
louis0606: posts small blind $0.05
Aarons AA: posts big blind $0.10
*** HOLE CARDS ***
Dealt to WI7ZZ [5s 9d]
WI7ZZ: folds 
M.Hakk1nen: folds 
KartenBob0815: folds 
Foosball1980: raises $0.12 to $0.22
louis0606: calls $0.17
Aarons AA: calls $0.12
*** FLOP *** [6c 5c 7s]
louis0606: checks 
Aarons AA: checks 
Foosball1980: checks 
*** TURN *** [6c 5c 7s] [6d]
louis0606: bets $0.30
Aarons AA: folds 
Foosball1980: folds 
Uncalled bet ($0.30) returned to louis0606
louis0606 collected $0.63 from pot
louis0606: doesn't show hand 
*** SUMMARY ***
Total pot $0.66 | Rake $0.03 
Board [6c 5c 7s 6d]
Seat 1: Foosball1980 (button) folded on the Turn
Seat 2: louis0606 (small blind) collected ($0.63)
Seat 3: Aarons AA (big blind) folded on the Turn
Seat 4: WI7ZZ folded before Flop (didn't bet)
Seat 5: M.Hakk1nen folded before Flop (didn't bet)
Seat 6: KartenBob0815 folded before Flop (didn't bet)



PokerStars Zoom Hand #188749549925:  Hold'em No Limit ($0.05/$0.10) - 2018/07/15 14:15:04 WET [2018/07/15 9:15:04 ET]
Table 'Aludra' 6-max Seat #1 is the button
Seat 1: WI7ZZ ($10.64 in chips) 
Seat 2: calthedude ($40.98 in chips) 
Seat 3: Foosball1980 ($10.02 in chips) 
Seat 4: hovlaa ($10 in chips) 
Seat 5: actionMoon ($10 in chips) 
Seat 6: Rude8oy9 ($25.90 in chips) 
calthedude: posts small blind $0.05
Foosball1980: posts big blind $0.10
*** HOLE CARDS ***
Dealt to WI7ZZ [Kc Th]
hovlaa: folds 
actionMoon: folds 
Rude8oy9: raises $0.20 to $0.30
WI7ZZ: raises $0.60 to $0.90
calthedude: folds 
Foosball1980: folds 
Rude8oy9: calls $0.60
*** FLOP *** [Qs Ad 5h]
Rude8oy9: checks 
WI7ZZ: bets $0.82
Rude8oy9: calls $0.82
*** TURN *** [Qs Ad 5h] [4h]
Rude8oy9: checks 
WI7ZZ: bets $2.13
Rude8oy9: folds 
Uncalled bet ($2.13) returned to WI7ZZ
WI7ZZ collected $3.43 from pot
WI7ZZ: doesn't show hand 
*** SUMMARY ***
Total pot $3.59 | Rake $0.16 
Board [Qs Ad 5h 4h]
Seat 1: WI7ZZ (button) collected ($3.43)
Seat 2: calthedude (small blind) folded before Flop
Seat 3: Foosball1980 (big blind) folded before Flop
Seat 4: hovlaa folded before Flop (didn't bet)
Seat 5: actionMoon folded before Flop (didn't bet)
Seat 6: Rude8oy9 folded on the Turn



PokerStars Zoom Hand #188749566695:  Hold'em No Limit ($0.05/$0.10) - 2018/07/15 14:15:37 WET [2018/07/15 9:15:37 ET]
Table 'Aludra' 6-max Seat #1 is the button
Seat 1: W71W ($10.79 in chips) 
Seat 2: AK_lucky_AK ($10.15 in chips) 
Seat 3: WI7ZZ ($12.35 in chips) 
Seat 4: ValiumJJ ($32.12 in chips) 
Seat 5: Foosball1980 ($10.25 in chips) 
Seat 6: Sergdoc71rus ($5.11 in chips) 
AK_lucky_AK: posts small blind $0.05
WI7ZZ: posts big blind $0.10
*** HOLE CARDS ***
Dealt to WI7ZZ [Ts 6c]
ValiumJJ: folds 
Foosball1980: folds 
Sergdoc71rus: raises $0.20 to $0.30
W71W: folds 
AK_lucky_AK: folds 
WI7ZZ: folds 
Uncalled bet ($0.20) returned to Sergdoc71rus
Sergdoc71rus collected $0.25 from pot
Sergdoc71rus: doesn't show hand 
*** SUMMARY ***
Total pot $0.25 | Rake $0 
Seat 1: W71W (button) folded before Flop (didn't bet)
Seat 2: AK_lucky_AK (small blind) folded before Flop
Seat 3: WI7ZZ (big blind) folded before Flop
Seat 4: ValiumJJ folded before Flop (didn't bet)
Seat 5: Foosball1980 folded before Flop (didn't bet)
Seat 6: Sergdoc71rus collected ($0.25)



PokerStars Zoom Hand #188749545185:  Hold'em No Limit ($0.05/$0.10) - 2018/07/15 14:14:55 WET [2018/07/15 9:14:55 ET]
Table 'Aludra' 6-max Seat #1 is the button
Seat 1: wongkosolsuk ($15.37 in chips) 
Seat 2: pro_raduga ($11.04 in chips) 
Seat 3: michaltoja ($10 in chips) 
Seat 4: shnackattack ($7.62 in chips) 
Seat 5: WI7ZZ ($10.69 in chips) 
Seat 6: ValiumJJ ($13.21 in chips) 
pro_raduga: posts small blind $0.05
michaltoja: posts big blind $0.10
*** HOLE CARDS ***
Dealt to WI7ZZ [Ks 6d]
shnackattack: calls $0.10
WI7ZZ: folds 
ValiumJJ: folds 
wongkosolsuk: calls $0.10
pro_raduga: folds 
michaltoja: checks 
*** FLOP *** [3s 3d Qh]
michaltoja: checks 
shnackattack: checks 
wongkosolsuk: checks 
*** TURN *** [3s 3d Qh] [9c]
michaltoja: bets $0.17
shnackattack: calls $0.17
wongkosolsuk: folds 
*** RIVER *** [3s 3d Qh 9c] [8d]
michaltoja: bets $0.22
shnackattack: calls $0.22
*** SHOW DOWN ***
michaltoja: shows [Qs 4d] (two pair, Queens and Threes)
shnackattack: mucks hand 
michaltoja collected $1.08 from pot
*** SUMMARY ***
Total pot $1.13 | Rake $0.05 
Board [3s 3d Qh 9c 8d]
Seat 1: wongkosolsuk (button) folded on the Turn
Seat 2: pro_raduga (small blind) folded before Flop
Seat 3: michaltoja (big blind) showed [Qs 4d] and won ($1.08) with two pair, Queens and Threes
Seat 4: shnackattack mucked [9d Td]
Seat 5: WI7ZZ folded before Flop (didn't bet)
Seat 6: ValiumJJ folded before Flop (didn't bet)



PokerStars Zoom Hand #188749571411:  Hold'em No Limit ($0.05/$0.10) - 2018/07/15 14:15:46 WET [2018/07/15 9:15:46 ET]
Table 'Aludra' 6-max Seat #1 is the button
Seat 1: WI7ZZ ($12.25 in chips) 
Seat 2: mikitok ($30.72 in chips) 
Seat 3: AgVolder ($20.90 in chips) 
Seat 4: padde886 ($10.38 in chips) 
Seat 5: TestaDiCazz ($10.25 in chips) 
Seat 6: Bravarian ($12.50 in chips) 
mikitok: posts small blind $0.05
AgVolder: posts big blind $0.10
*** HOLE CARDS ***
Dealt to WI7ZZ [6c Kc]
padde886: folds 
TestaDiCazz: folds 
Bravarian: folds 
WI7ZZ: raises $0.16 to $0.26
mikitok: folds 
AgVolder: folds 
Uncalled bet ($0.16) returned to WI7ZZ
WI7ZZ collected $0.25 from pot
WI7ZZ: doesn't show hand 
*** SUMMARY ***
Total pot $0.25 | Rake $0 
Seat 1: WI7ZZ (button) collected ($0.25)
Seat 2: mikitok (small blind) folded before Flop
Seat 3: AgVolder (big blind) folded before Flop
Seat 4: padde886 folded before Flop (didn't bet)
Seat 5: TestaDiCazz folded before Flop (didn't bet)
Seat 6: Bravarian folded before Flop (didn't bet)



PokerStars Zoom Hand #188749565133:  Hold'em No Limit ($0.05/$0.10) - 2018/07/15 14:15:34 WET [2018/07/15 9:15:34 ET]
Table 'Aludra' 6-max Seat #1 is the button
Seat 1: kotlecior ($40.26 in chips) 
Seat 2: WhiteDAGLeki ($10.65 in chips) 
Seat 3: Paraillusion ($13.55 in chips) 
Seat 4: Evgenij1977 ($12.18 in chips) 
Seat 5: Sunrise1912 ($18.22 in chips) 
Seat 6: WI7ZZ ($12.35 in chips) 
WhiteDAGLeki: posts small blind $0.05
Paraillusion: posts big blind $0.10
*** HOLE CARDS ***
Dealt to WI7ZZ [2c Ah]
Evgenij1977: raises $0.17 to $0.27
Sunrise1912: raises $0.69 to $0.96
WI7ZZ: folds 
kotlecior: folds 
WhiteDAGLeki: folds 
Paraillusion: folds 
Evgenij1977: calls $0.69
*** FLOP *** [7d 4h 7c]
Evgenij1977: checks 
Sunrise1912: checks 
*** TURN *** [7d 4h 7c] [5c]
Evgenij1977: checks 
Sunrise1912: checks 
*** RIVER *** [7d 4h 7c 5c] [Tc]
Evgenij1977: bets $11.22 and is all-in
Sunrise1912: folds 
Uncalled bet ($11.22) returned to Evgenij1977
Evgenij1977 collected $1.98 from pot
Evgenij1977: doesn't show hand 
*** SUMMARY ***
Total pot $2.07 | Rake $0.09 
Board [7d 4h 7c 5c Tc]
Seat 1: kotlecior (button) folded before Flop (didn't bet)
Seat 2: WhiteDAGLeki (small blind) folded before Flop
Seat 3: Paraillusion (big blind) folded before Flop
Seat 4: Evgenij1977 collected ($1.98)
Seat 5: Sunrise1912 folded on the River
Seat 6: WI7ZZ folded before Flop (didn't bet)



PokerStars Zoom Hand #188749581222:  Hold'em No Limit ($0.05/$0.10) - 2018/07/15 14:16:05 WET [2018/07/15 9:16:05 ET]
Table 'Aludra' 6-max Seat #1 is the button
Seat 1: ultra radi ($14.01 in chips) 
Seat 2: WI7ZZ ($12.40 in chips) 
Seat 3: Totosha333 ($5.48 in chips) 
Seat 4: malotou ($10.10 in chips) 
Seat 5: Kummitaja ($11.38 in chips) 
Seat 6: Foosball1980 ($11.36 in chips) 
WI7ZZ: posts small blind $0.05
Totosha333: posts big blind $0.10
*** HOLE CARDS ***
Dealt to WI7ZZ [7h Ad]
malotou: folds 
Kummitaja: folds 
Foosball1980: folds 
ultra radi: folds 
WI7ZZ: folds 
Uncalled bet ($0.05) returned to Totosha333
Totosha333 collected $0.10 from pot
Totosha333: doesn't show hand 
*** SUMMARY ***
Total pot $0.10 | Rake $0 
Seat 1: ultra radi (button) folded before Flop (didn't bet)
Seat 2: WI7ZZ (small blind) folded before Flop
Seat 3: Totosha333 (big blind) collected ($0.10)
Seat 4: malotou folded before Flop (didn't bet)
Seat 5: Kummitaja folded before Flop (didn't bet)
Seat 6: Foosball1980 folded before Flop (didn't bet)



PokerStars Zoom Hand #188749583746:  Hold'em No Limit ($0.05/$0.10) - 2018/07/15 14:16:10 WET [2018/07/15 9:16:10 ET]
Table 'Aludra' 6-max Seat #1 is the button
Seat 1: qqzan ($10.05 in chips) 
Seat 2: GuiBenites ($17.06 in chips) 
Seat 3: impulsivo ($10 in chips) 
Seat 4: Eregne ($12.62 in chips) 
Seat 5: Dan0505 ($4.08 in chips) 
Seat 6: WI7ZZ ($12.35 in chips) 
GuiBenites: posts small blind $0.05
impulsivo: posts big blind $0.10
*** HOLE CARDS ***
Dealt to WI7ZZ [2h 4h]
Eregne: folds 
Dan0505: raises $0.10 to $0.20
WI7ZZ: folds 
qqzan: folds 
GuiBenites: folds 
impulsivo: folds 
Uncalled bet ($0.10) returned to Dan0505
Dan0505 collected $0.25 from pot
Dan0505: doesn't show hand 
*** SUMMARY ***
Total pot $0.25 | Rake $0 
Seat 1: qqzan (button) folded before Flop (didn't bet)
Seat 2: GuiBenites (small blind) folded before Flop
Seat 3: impulsivo (big blind) folded before Flop
Seat 4: Eregne folded before Flop (didn't bet)
Seat 5: Dan0505 collected ($0.25)
Seat 6: WI7ZZ folded before Flop (didn't bet)



PokerStars Zoom Hand #188749582737:  Hold'em No Limit ($0.05/$0.10) - 2018/07/15 14:16:08 WET [2018/07/15 9:16:08 ET]
Table 'Aludra' 6-max Seat #1 is the button
Seat 1: Predtecha87 ($12.14 in chips) 
Seat 2: Pardaroxon ($10.05 in chips) 
Seat 3: SpaceMonk25 ($10 in chips) 
Seat 4: WI7ZZ ($12.35 in chips) 
Seat 5: APavlychev ($18.31 in chips) 
Seat 6: Sunrise1912 ($17.26 in chips) 
Pardaroxon: posts small blind $0.05
SpaceMonk25: posts big blind $0.10
*** HOLE CARDS ***
Dealt to WI7ZZ [4d 5h]
WI7ZZ: folds 
APavlychev: folds 
Sunrise1912: raises $0.20 to $0.30
Predtecha87: folds 
Pardaroxon: folds 
SpaceMonk25: folds 
Uncalled bet ($0.20) returned to Sunrise1912
Sunrise1912 collected $0.25 from pot
Sunrise1912: doesn't show hand 
*** SUMMARY ***
Total pot $0.25 | Rake $0 
Seat 1: Predtecha87 (button) folded before Flop (didn't bet)
Seat 2: Pardaroxon (small blind) folded before Flop
Seat 3: SpaceMonk25 (big blind) folded before Flop
Seat 4: WI7ZZ folded before Flop (didn't bet)
Seat 5: APavlychev folded before Flop (didn't bet)
Seat 6: Sunrise1912 collected ($0.25)



PokerStars Zoom Hand #188749599154:  Hold'em No Limit ($0.05/$0.10) - 2018/07/15 14:16:40 WET [2018/07/15 9:16:40 ET]
Table 'Aludra' 6-max Seat #1 is the button
Seat 1: MYSTYRIOS ($8.55 in chips) 
Seat 2: indextown ($10 in chips) 
Seat 3: WI7ZZ ($12.05 in chips) 
Seat 4: Tahoe30LT ($14.21 in chips) 
Seat 5: calthedude ($40.83 in chips) 
Seat 6: Sunrise1912 ($11.38 in chips) 
indextown: posts small blind $0.05
WI7ZZ: posts big blind $0.10
*** HOLE CARDS ***
Dealt to WI7ZZ [Ts Td]
Tahoe30LT: folds 
calthedude: folds 
Sunrise1912: folds 
MYSTYRIOS: raises $0.10 to $0.20
indextown: folds 
WI7ZZ: raises $0.50 to $0.70
MYSTYRIOS: calls $0.50
*** FLOP *** [As 7h Kh]
WI7ZZ: bets $0.61
MYSTYRIOS: calls $0.61
*** TURN *** [As 7h Kh] [4s]
WI7ZZ: checks 
MYSTYRIOS: bets $1
WI7ZZ: folds 
Uncalled bet ($1) returned to MYSTYRIOS
MYSTYRIOS collected $2.55 from pot
*** SUMMARY ***
Total pot $2.67 | Rake $0.12 
Board [As 7h Kh 4s]
Seat 1: MYSTYRIOS (button) collected ($2.55)
Seat 2: indextown (small blind) folded before Flop
Seat 3: WI7ZZ (big blind) folded on the Turn
Seat 4: Tahoe30LT folded before Flop (didn't bet)
Seat 5: calthedude folded before Flop (didn't bet)
Seat 6: Sunrise1912 folded before Flop (didn't bet)



PokerStars Zoom Hand #188749585252:  Hold'em No Limit ($0.05/$0.10) - 2018/07/15 14:16:13 WET [2018/07/15 9:16:13 ET]
Table 'Aludra' 6-max Seat #1 is the button
Seat 1: mentaltony ($9.01 in chips) 
Seat 2: WI7ZZ ($12.35 in chips) 
Seat 3: signofme ($10.57 in chips) 
Seat 4: -=l Grek l=- ($46.90 in chips) 
Seat 5: VOVAN_888_999 ($5.58 in chips) 
Seat 6: TestaDiCazz ($10.18 in chips) 
WI7ZZ: posts small blind $0.05
signofme: posts big blind $0.10
*** HOLE CARDS ***
Dealt to WI7ZZ [7s 7d]
-=l Grek l=-: raises $0.20 to $0.30
VOVAN_888_999: folds 
TestaDiCazz: folds 
mentaltony: calls $0.30
WI7ZZ: calls $0.25
signofme: folds 
*** FLOP *** [8h 3h Kd]
WI7ZZ: checks 
-=l Grek l=-: bets $0.50
mentaltony: calls $0.50
WI7ZZ: folds 
*** TURN *** [8h 3h Kd] [4d]
-=l Grek l=-: bets $1
mentaltony: calls $1
*** RIVER *** [8h 3h Kd 4d] [7h]
-=l Grek l=-: checks 
mentaltony: bets $2.80
-=l Grek l=-: folds 
Uncalled bet ($2.80) returned to mentaltony
mentaltony collected $3.82 from pot
mentaltony: doesn't show hand 
*** SUMMARY ***
Total pot $4 | Rake $0.18 
Board [8h 3h Kd 4d 7h]
Seat 1: mentaltony (button) collected ($3.82)
Seat 2: WI7ZZ (small blind) folded on the Flop
Seat 3: signofme (big blind) folded before Flop
Seat 4: -=l Grek l=- folded on the River
Seat 5: VOVAN_888_999 folded before Flop (didn't bet)
Seat 6: TestaDiCazz folded before Flop (didn't bet)



PokerStars Zoom Hand #188749626371:  Hold'em No Limit ($0.05/$0.10) - 2018/07/15 14:17:33 WET [2018/07/15 9:17:33 ET]
Table 'Aludra' 6-max Seat #1 is the button
Seat 1: Bravarian ($9.09 in chips) 
Seat 2: CafeDay ($11.12 in chips) 
Seat 3: Plevi1 ($14.50 in chips) 
Seat 4: mentaltony ($14.45 in chips) 
Seat 5: WI7ZZ ($10.74 in chips) 
Seat 6: klrcwang ($12.61 in chips) 
CafeDay: posts small blind $0.05
Plevi1: posts big blind $0.10
*** HOLE CARDS ***
Dealt to WI7ZZ [6c 9h]
mentaltony: folds 
WI7ZZ: folds 
klrcwang: raises $0.20 to $0.30
Bravarian: folds 
CafeDay: folds 
Plevi1: folds 
Uncalled bet ($0.20) returned to klrcwang
klrcwang collected $0.25 from pot
klrcwang: doesn't show hand 
*** SUMMARY ***
Total pot $0.25 | Rake $0 
Seat 1: Bravarian (button) folded before Flop (didn't bet)
Seat 2: CafeDay (small blind) folded before Flop
Seat 3: Plevi1 (big blind) folded before Flop
Seat 4: mentaltony folded before Flop (didn't bet)
Seat 5: WI7ZZ folded before Flop (didn't bet)
Seat 6: klrcwang collected ($0.25)



PokerStars Zoom Hand #188749629937:  Hold'em No Limit ($0.05/$0.10) - 2018/07/15 14:17:40 WET [2018/07/15 9:17:40 ET]
Table 'Aludra' 6-max Seat #1 is the button
Seat 1: -=l Grek l=- ($17.69 in chips) 
Seat 2: MOU77Y ($10.51 in chips) 
Seat 3: AnHoCa ($11.29 in chips) 
Seat 4: Predtecha87 ($12.01 in chips) 
Seat 5: hellf1re666 ($10.79 in chips) 
Seat 6: WI7ZZ ($10.74 in chips) 
MOU77Y: posts small blind $0.05
AnHoCa: posts big blind $0.10
*** HOLE CARDS ***
Dealt to WI7ZZ [4d 9d]
Predtecha87: folds 
hellf1re666: folds 
WI7ZZ: folds 
-=l Grek l=-: folds 
MOU77Y: folds 
Uncalled bet ($0.05) returned to AnHoCa
AnHoCa collected $0.10 from pot
AnHoCa: doesn't show hand 
*** SUMMARY ***
Total pot $0.10 | Rake $0 
Seat 1: -=l Grek l=- (button) folded before Flop (didn't bet)
Seat 2: MOU77Y (small blind) folded before Flop
Seat 3: AnHoCa (big blind) collected ($0.10)
Seat 4: Predtecha87 folded before Flop (didn't bet)
Seat 5: hellf1re666 folded before Flop (didn't bet)
Seat 6: WI7ZZ folded before Flop (didn't bet)



PokerStars Zoom Hand #188749627903:  Hold'em No Limit ($0.05/$0.10) - 2018/07/15 14:17:36 WET [2018/07/15 9:17:36 ET]
Table 'Aludra' 6-max Seat #1 is the button
Seat 1: WI7ZZ ($10.74 in chips) 
Seat 2: Sunrise1912 ($18.15 in chips) 
Seat 3: ValiumJJ ($32.30 in chips) 
Seat 4: Dalibomba ($10 in chips) 
Seat 5: g.kotzas ($22.69 in chips) 
Seat 6: ilyhaha ($9.66 in chips) 
Sunrise1912: posts small blind $0.05
ValiumJJ: posts big blind $0.10
*** HOLE CARDS ***
Dealt to WI7ZZ [Td 3c]
Dalibomba: folds 
g.kotzas: folds 
ilyhaha: folds 
WI7ZZ: folds 
Sunrise1912: raises $0.30 to $0.40
ValiumJJ: folds 
Uncalled bet ($0.30) returned to Sunrise1912
Sunrise1912 collected $0.20 from pot
Sunrise1912: doesn't show hand 
*** SUMMARY ***
Total pot $0.20 | Rake $0 
Seat 1: WI7ZZ (button) folded before Flop (didn't bet)
Seat 2: Sunrise1912 (small blind) collected ($0.20)
Seat 3: ValiumJJ (big blind) folded before Flop
Seat 4: Dalibomba folded before Flop (didn't bet)
Seat 5: g.kotzas folded before Flop (didn't bet)
Seat 6: ilyhaha folded before Flop (didn't bet)



PokerStars Zoom Hand #188749624817:  Hold'em No Limit ($0.05/$0.10) - 2018/07/15 14:17:30 WET [2018/07/15 9:17:30 ET]
Table 'Aludra' 6-max Seat #1 is the button
Seat 1: iDecMate ($10.40 in chips) 
Seat 2: Eregne ($11.48 in chips) 
Seat 3: qqzan ($10 in chips) 
Seat 4: shu1007 ($18.30 in chips) 
Seat 5: WI7ZZ ($10.74 in chips) 
Seat 6: joedinskide ($15.78 in chips) 
Eregne: posts small blind $0.05
qqzan: posts big blind $0.10
*** HOLE CARDS ***
Dealt to WI7ZZ [2d 4d]
shu1007: folds 
WI7ZZ: folds 
joedinskide: raises $0.20 to $0.30
iDecMate: folds 
Eregne: folds 
qqzan: folds 
Uncalled bet ($0.20) returned to joedinskide
joedinskide collected $0.25 from pot
joedinskide: doesn't show hand 
*** SUMMARY ***
Total pot $0.25 | Rake $0 
Seat 1: iDecMate (button) folded before Flop (didn't bet)
Seat 2: Eregne (small blind) folded before Flop
Seat 3: qqzan (big blind) folded before Flop
Seat 4: shu1007 folded before Flop (didn't bet)
Seat 5: WI7ZZ folded before Flop (didn't bet)
Seat 6: joedinskide collected ($0.25)



PokerStars Zoom Hand #188749631498:  Hold'em No Limit ($0.05/$0.10) - 2018/07/15 14:17:43 WET [2018/07/15 9:17:43 ET]
Table 'Aludra' 6-max Seat #1 is the button
Seat 1: Bravarian ($6.70 in chips) 
Seat 2: Pardaroxon ($10.94 in chips) 
Seat 3: Sunrise1912 ($16.48 in chips) 
Seat 4: WI7ZZ ($10.74 in chips) 
Seat 5: MOU77Y ($10.46 in chips) 
Seat 6: PollyPeachum ($10.77 in chips) 
Pardaroxon: posts small blind $0.05
Sunrise1912: posts big blind $0.10
*** HOLE CARDS ***
Dealt to WI7ZZ [Ac 8s]
WI7ZZ: folds 
MOU77Y: folds 
PollyPeachum: folds 
Bravarian: calls $0.10
Pardaroxon: folds 
Sunrise1912: checks 
*** FLOP *** [Jh 2c 8d]
Sunrise1912: checks 
Bravarian: bets $0.24
Sunrise1912: calls $0.24
*** TURN *** [Jh 2c 8d] [6d]
Sunrise1912: checks 
Bravarian: bets $0.35
Sunrise1912: calls $0.35
*** RIVER *** [Jh 2c 8d 6d] [6s]
Sunrise1912: checks 
Bravarian: checks 
*** SHOW DOWN ***
Sunrise1912: shows [2d Kd] (two pair, Sixes and Deuces)
Bravarian: shows [8c Kc] (two pair, Eights and Sixes)
Bravarian collected $1.37 from pot
*** SUMMARY ***
Total pot $1.43 | Rake $0.06 
Board [Jh 2c 8d 6d 6s]
Seat 1: Bravarian (button) showed [8c Kc] and won ($1.37) with two pair, Eights and Sixes
Seat 2: Pardaroxon (small blind) folded before Flop
Seat 3: Sunrise1912 (big blind) showed [2d Kd] and lost with two pair, Sixes and Deuces
Seat 4: WI7ZZ folded before Flop (didn't bet)
Seat 5: MOU77Y folded before Flop (didn't bet)
Seat 6: PollyPeachum folded before Flop (didn't bet)



PokerStars Zoom Hand #188749639858:  Hold'em No Limit ($0.05/$0.10) - 2018/07/15 14:17:59 WET [2018/07/15 9:17:59 ET]
Table 'Aludra' 6-max Seat #1 is the button
Seat 1: kazyunok ($9.95 in chips) 
Seat 2: WI7ZZ ($10.64 in chips) 
Seat 3: padde886 ($10 in chips) 
Seat 4: ancsa90 ($10.50 in chips) 
Seat 5: Foosball1980 ($11.05 in chips) 
Seat 6: ChungkingExp ($10 in chips) 
WI7ZZ: posts small blind $0.05
padde886: posts big blind $0.10
*** HOLE CARDS ***
Dealt to WI7ZZ [3c 4c]
ancsa90: folds 
Foosball1980: folds 
ChungkingExp: folds 
kazyunok: folds 
WI7ZZ: raises $0.16 to $0.26
padde886: folds 
Uncalled bet ($0.16) returned to WI7ZZ
WI7ZZ collected $0.20 from pot
WI7ZZ: doesn't show hand 
*** SUMMARY ***
Total pot $0.20 | Rake $0 
Seat 1: kazyunok (button) folded before Flop (didn't bet)
Seat 2: WI7ZZ (small blind) collected ($0.20)
Seat 3: padde886 (big blind) folded before Flop
Seat 4: ancsa90 folded before Flop (didn't bet)
Seat 5: Foosball1980 folded before Flop (didn't bet)
Seat 6: ChungkingExp folded before Flop (didn't bet)



PokerStars Zoom Hand #188749633073:  Hold'em No Limit ($0.05/$0.10) - 2018/07/15 14:17:46 WET [2018/07/15 9:17:46 ET]
Table 'Aludra' 6-max Seat #1 is the button
Seat 1: mentaltony ($14.40 in chips) 
Seat 2: GuiBenites ($37.75 in chips) 
Seat 3: WI7ZZ ($10.74 in chips) 
Seat 4: AgVolder ($20.80 in chips) 
Seat 5: knullig ($8.48 in chips) 
Seat 6: signofme ($13.03 in chips) 
GuiBenites: posts small blind $0.05
WI7ZZ: posts big blind $0.10
*** HOLE CARDS ***
Dealt to WI7ZZ [Qh 6s]
AgVolder: folds 
knullig: folds 
signofme: folds 
mentaltony: raises $0.14 to $0.24
GuiBenites: calls $0.19
WI7ZZ: folds 
*** FLOP *** [Td 9h 5s]
GuiBenites: checks 
mentaltony: checks 
*** TURN *** [Td 9h 5s] [Th]
GuiBenites: bets $0.10
mentaltony: folds 
Uncalled bet ($0.10) returned to GuiBenites
GuiBenites collected $0.55 from pot
GuiBenites: doesn't show hand 
*** SUMMARY ***
Total pot $0.58 | Rake $0.03 
Board [Td 9h 5s Th]
Seat 1: mentaltony (button) folded on the Turn
Seat 2: GuiBenites (small blind) collected ($0.55)
Seat 3: WI7ZZ (big blind) folded before Flop
Seat 4: AgVolder folded before Flop (didn't bet)
Seat 5: knullig folded before Flop (didn't bet)
Seat 6: signofme folded before Flop (didn't bet)



PokerStars Zoom Hand #188749649679:  Hold'em No Limit ($0.05/$0.10) - 2018/07/15 14:18:18 WET [2018/07/15 9:18:18 ET]
Table 'Aludra' 6-max Seat #1 is the button
Seat 1: M.Hakk1nen ($7.41 in chips) 
Seat 2: CafeDay ($10 in chips) 
Seat 3: mula200 ($10.15 in chips) 
Seat 4: Kummitaja ($11.38 in chips) 
Seat 5: naymaierbra ($10 in chips) 
Seat 6: WI7ZZ ($10.74 in chips) 
CafeDay: posts small blind $0.05
mula200: posts big blind $0.10
*** HOLE CARDS ***
Dealt to WI7ZZ [7d 9h]
Kummitaja: folds 
naymaierbra: folds 
WI7ZZ: folds 
M.Hakk1nen: folds 
CafeDay: folds 
Uncalled bet ($0.05) returned to mula200
mula200 collected $0.10 from pot
mula200: doesn't show hand 
*** SUMMARY ***
Total pot $0.10 | Rake $0 
Seat 1: M.Hakk1nen (button) folded before Flop (didn't bet)
Seat 2: CafeDay (small blind) folded before Flop
Seat 3: mula200 (big blind) collected ($0.10)
Seat 4: Kummitaja folded before Flop (didn't bet)
Seat 5: naymaierbra folded before Flop (didn't bet)
Seat 6: WI7ZZ folded before Flop (didn't bet)



PokerStars Zoom Hand #188749652737:  Hold'em No Limit ($0.05/$0.10) - 2018/07/15 14:18:24 WET [2018/07/15 9:18:24 ET]
Table 'Aludra' 6-max Seat #1 is the button
Seat 1: WI7ZZ ($10.74 in chips) 
Seat 2: blasterrrtje ($13.59 in chips) 
Seat 3: MYSTYRIOS ($9.96 in chips) 
Seat 4: Dragonslyer1337 ($13.51 in chips) 
Seat 5: knullig ($8.48 in chips) 
Seat 6: Marsiz ($16.21 in chips) 
blasterrrtje: posts small blind $0.05
MYSTYRIOS: posts big blind $0.10
*** HOLE CARDS ***
Dealt to WI7ZZ [9h 7c]
Dragonslyer1337: folds 
knullig: folds 
Marsiz: folds 
WI7ZZ: folds 
blasterrrtje: folds 
Uncalled bet ($0.05) returned to MYSTYRIOS
MYSTYRIOS collected $0.10 from pot
MYSTYRIOS: doesn't show hand 
*** SUMMARY ***
Total pot $0.10 | Rake $0 
Seat 1: WI7ZZ (button) folded before Flop (didn't bet)
Seat 2: blasterrrtje (small blind) folded before Flop
Seat 3: MYSTYRIOS (big blind) collected ($0.10)
Seat 4: Dragonslyer1337 folded before Flop (didn't bet)
Seat 5: knullig folded before Flop (didn't bet)
Seat 6: Marsiz folded before Flop (didn't bet)



PokerStars Zoom Hand #188749655880:  Hold'em No Limit ($0.05/$0.10) - 2018/07/15 14:18:30 WET [2018/07/15 9:18:30 ET]
Table 'Aludra' 6-max Seat #1 is the button
Seat 1: knullig ($8.48 in chips) 
Seat 2: WI7ZZ ($10.74 in chips) 
Seat 3: Predtecha87 ($11.44 in chips) 
Seat 4: M.Hakk1nen ($7.36 in chips) 
Seat 5: niqqa48 ($18.39 in chips) 
Seat 6: ancsa90 ($9.90 in chips) 
WI7ZZ: posts small blind $0.05
Predtecha87: posts big blind $0.10
*** HOLE CARDS ***
Dealt to WI7ZZ [3s Kc]
M.Hakk1nen: folds 
niqqa48: folds 
ancsa90: folds 
knullig: folds 
WI7ZZ: folds 
Uncalled bet ($0.05) returned to Predtecha87
Predtecha87 collected $0.10 from pot
Predtecha87: doesn't show hand 
*** SUMMARY ***
Total pot $0.10 | Rake $0 
Seat 1: knullig (button) folded before Flop (didn't bet)
Seat 2: WI7ZZ (small blind) folded before Flop
Seat 3: Predtecha87 (big blind) collected ($0.10)
Seat 4: M.Hakk1nen folded before Flop (didn't bet)
Seat 5: niqqa48 folded before Flop (didn't bet)
Seat 6: ancsa90 folded before Flop (didn't bet)



PokerStars Zoom Hand #188749651227:  Hold'em No Limit ($0.05/$0.10) - 2018/07/15 14:18:21 WET [2018/07/15 9:18:21 ET]
Table 'Aludra' 6-max Seat #1 is the button
Seat 1: Foosball1980 ($11.56 in chips) 
Seat 2: pro_raduga ($10.74 in chips) 
Seat 3: xabaza ($10 in chips) 
Seat 4: SydneyBridge ($8.85 in chips) 
Seat 5: WI7ZZ ($10.74 in chips) 
Seat 6: Predtecha87 ($11.18 in chips) 
pro_raduga: posts small blind $0.05
xabaza: posts big blind $0.10
*** HOLE CARDS ***
Dealt to WI7ZZ [5h As]
SydneyBridge: folds 
WI7ZZ: folds 
Predtecha87: folds 
Foosball1980: raises $0.12 to $0.22
pro_raduga: folds 
xabaza: folds 
Uncalled bet ($0.12) returned to Foosball1980
Foosball1980 collected $0.25 from pot
Foosball1980: doesn't show hand 
*** SUMMARY ***
Total pot $0.25 | Rake $0 
Seat 1: Foosball1980 (button) collected ($0.25)
Seat 2: pro_raduga (small blind) folded before Flop
Seat 3: xabaza (big blind) folded before Flop
Seat 4: SydneyBridge folded before Flop (didn't bet)
Seat 5: WI7ZZ folded before Flop (didn't bet)
Seat 6: Predtecha87 folded before Flop (didn't bet)



PokerStars Zoom Hand #188749654336:  Hold'em No Limit ($0.05/$0.10) - 2018/07/15 14:18:27 WET [2018/07/15 9:18:27 ET]
Table 'Aludra' 6-max Seat #1 is the button
Seat 1: TestaDiCazz ($10 in chips) 
Seat 2: michaltoja ($15.91 in chips) 
Seat 3: scotseng ($12.93 in chips) 
Seat 4: WI7ZZ ($10.74 in chips) 
Seat 5: AK_lucky_AK ($11.81 in chips) 
Seat 6: actionMoon ($10 in chips) 
michaltoja: posts small blind $0.05
scotseng: posts big blind $0.10
*** HOLE CARDS ***
Dealt to WI7ZZ [2c 9c]
WI7ZZ: folds 
AK_lucky_AK: folds 
actionMoon: folds 
TestaDiCazz: raises $0.13 to $0.23
michaltoja: folds 
scotseng: raises $0.61 to $0.84
TestaDiCazz: folds 
Uncalled bet ($0.61) returned to scotseng
scotseng collected $0.51 from pot
scotseng: doesn't show hand 
*** SUMMARY ***
Total pot $0.51 | Rake $0 
Seat 1: TestaDiCazz (button) folded before Flop
Seat 2: michaltoja (small blind) folded before Flop
Seat 3: scotseng (big blind) collected ($0.51)
Seat 4: WI7ZZ folded before Flop (didn't bet)
Seat 5: AK_lucky_AK folded before Flop (didn't bet)
Seat 6: actionMoon folded before Flop (didn't bet)



PokerStars Zoom Hand #188749659537:  Hold'em No Limit ($0.05/$0.10) - 2018/07/15 14:18:37 WET [2018/07/15 9:18:37 ET]
Table 'Aludra' 6-max Seat #1 is the button
Seat 1: Pardaroxon ($15.68 in chips) 
Seat 2: freeclimber6 ($15.60 in chips) 
Seat 3: WI7ZZ ($10.69 in chips) 
Seat 4: hovlaa ($16.10 in chips) 
Seat 5: redsy22 ($17.36 in chips) 
Seat 6: malotou ($8.47 in chips) 
freeclimber6: posts small blind $0.05
WI7ZZ: posts big blind $0.10
*** HOLE CARDS ***
Dealt to WI7ZZ [9s 3d]
hovlaa: folds 
redsy22: raises $0.20 to $0.30
malotou: folds 
Pardaroxon: folds 
freeclimber6: folds 
WI7ZZ: folds 
Uncalled bet ($0.20) returned to redsy22
redsy22 collected $0.25 from pot
redsy22: doesn't show hand 
*** SUMMARY ***
Total pot $0.25 | Rake $0 
Seat 1: Pardaroxon (button) folded before Flop (didn't bet)
Seat 2: freeclimber6 (small blind) folded before Flop
Seat 3: WI7ZZ (big blind) folded before Flop
Seat 4: hovlaa folded before Flop (didn't bet)
Seat 5: redsy22 collected ($0.25)
Seat 6: malotou folded before Flop (didn't bet)



PokerStars Zoom Hand #188749664188:  Hold'em No Limit ($0.05/$0.10) - 2018/07/15 14:18:46 WET [2018/07/15 9:18:46 ET]
Table 'Aludra' 6-max Seat #1 is the button
Seat 1: WI7ZZ ($10.59 in chips) 
Seat 2: maktuiu ($24.38 in chips) 
Seat 3: Totosha333 ($8.33 in chips) 
Seat 4: Kummitaja ($11.38 in chips) 
Seat 5: Foosball1980 ($11.71 in chips) 
Seat 6: naymaierbra ($10 in chips) 
maktuiu: posts small blind $0.05
Totosha333: posts big blind $0.10
*** HOLE CARDS ***
Dealt to WI7ZZ [Ts 2s]
Kummitaja: folds 
Foosball1980: folds 
naymaierbra: folds 
WI7ZZ: folds 
maktuiu: folds 
Uncalled bet ($0.05) returned to Totosha333
Totosha333 collected $0.10 from pot
Totosha333: doesn't show hand 
*** SUMMARY ***
Total pot $0.10 | Rake $0 
Seat 1: WI7ZZ (button) folded before Flop (didn't bet)
Seat 2: maktuiu (small blind) folded before Flop
Seat 3: Totosha333 (big blind) collected ($0.10)
Seat 4: Kummitaja folded before Flop (didn't bet)
Seat 5: Foosball1980 folded before Flop (didn't bet)
Seat 6: naymaierbra folded before Flop (didn't bet)



PokerStars Zoom Hand #188749665226:  Hold'em No Limit ($0.05/$0.10) - 2018/07/15 14:18:48 WET [2018/07/15 9:18:48 ET]
Table 'Aludra' 6-max Seat #1 is the button
Seat 1: youngteen ($10 in chips) 
Seat 2: GROM84 ($10.05 in chips) 
Seat 3: pro_raduga ($10 in chips) 
Seat 4: XXschmidtX ($22.01 in chips) 
Seat 5: incredibleuh ($16.84 in chips) 
Seat 6: WI7ZZ ($10.59 in chips) 
GROM84: posts small blind $0.05
pro_raduga: posts big blind $0.10
*** HOLE CARDS ***
Dealt to WI7ZZ [3c 8h]
XXschmidtX: folds 
incredibleuh: folds 
WI7ZZ: folds 
youngteen: folds 
GROM84: folds 
Uncalled bet ($0.05) returned to pro_raduga
pro_raduga collected $0.10 from pot
pro_raduga: doesn't show hand 
*** SUMMARY ***
Total pot $0.10 | Rake $0 
Seat 1: youngteen (button) folded before Flop (didn't bet)
Seat 2: GROM84 (small blind) folded before Flop
Seat 3: pro_raduga (big blind) collected ($0.10)
Seat 4: XXschmidtX folded before Flop (didn't bet)
Seat 5: incredibleuh folded before Flop (didn't bet)
Seat 6: WI7ZZ folded before Flop (didn't bet)



PokerStars Zoom Hand #188749668337:  Hold'em No Limit ($0.05/$0.10) - 2018/07/15 14:18:54 WET [2018/07/15 9:18:54 ET]
Table 'Aludra' 6-max Seat #1 is the button
Seat 1: M.Hakk1nen ($7.21 in chips) 
Seat 2: andypr0 ($55.88 in chips) 
Seat 3: WI7ZZ ($10.59 in chips) 
Seat 4: Andreas.P305 ($12.40 in chips) 
Seat 5: GuiBenites ($17.85 in chips) 
Seat 6: padde886 ($11.03 in chips) 
andypr0: posts small blind $0.05
WI7ZZ: posts big blind $0.10
*** HOLE CARDS ***
Dealt to WI7ZZ [Ks 7h]
Andreas.P305: folds 
GuiBenites: raises $0.20 to $0.30
padde886: folds 
M.Hakk1nen: folds 
andypr0: folds 
WI7ZZ: folds 
Uncalled bet ($0.20) returned to GuiBenites
GuiBenites collected $0.25 from pot
*** SUMMARY ***
Total pot $0.25 | Rake $0 
Seat 1: M.Hakk1nen (button) folded before Flop (didn't bet)
Seat 2: andypr0 (small blind) folded before Flop
Seat 3: WI7ZZ (big blind) folded before Flop
Seat 4: Andreas.P305 folded before Flop (didn't bet)
Seat 5: GuiBenites collected ($0.25)
Seat 6: padde886 folded before Flop (didn't bet)



PokerStars Zoom Hand #188749666773:  Hold'em No Limit ($0.05/$0.10) - 2018/07/15 14:18:51 WET [2018/07/15 9:18:51 ET]
Table 'Aludra' 6-max Seat #1 is the button
Seat 1: QuakieMan ($30.43 in chips) 
Seat 2: kamikaza11 ($12.27 in chips) 
Seat 3: donghatimpy ($11.06 in chips) 
Seat 4: Dalibomba ($11.87 in chips) 
Seat 5: WI7ZZ ($10.59 in chips) 
Seat 6: Eregne ($10 in chips) 
kamikaza11: posts small blind $0.05
donghatimpy: posts big blind $0.10
*** HOLE CARDS ***
Dealt to WI7ZZ [3s Td]
Dalibomba: raises $0.15 to $0.25
WI7ZZ: folds 
Eregne: folds 
QuakieMan: folds 
kamikaza11: folds 
donghatimpy: calls $0.15
*** FLOP *** [Th Ah Qc]
donghatimpy: checks 
Dalibomba: bets $0.17
donghatimpy: folds 
Uncalled bet ($0.17) returned to Dalibomba
Dalibomba collected $0.53 from pot
Dalibomba: doesn't show hand 
*** SUMMARY ***
Total pot $0.55 | Rake $0.02 
Board [Th Ah Qc]
Seat 1: QuakieMan (button) folded before Flop (didn't bet)
Seat 2: kamikaza11 (small blind) folded before Flop
Seat 3: donghatimpy (big blind) folded on the Flop
Seat 4: Dalibomba collected ($0.53)
Seat 5: WI7ZZ folded before Flop (didn't bet)
Seat 6: Eregne folded before Flop (didn't bet)



PokerStars Zoom Hand #188749676540:  Hold'em No Limit ($0.05/$0.10) - 2018/07/15 14:19:10 WET [2018/07/15 9:19:10 ET]
Table 'Aludra' 6-max Seat #1 is the button
Seat 1: Mr.Terek ($10.45 in chips) 
Seat 2: WI7ZZ ($10.49 in chips) 
Seat 3: Ednhukm ($7.24 in chips) 
Seat 4: XXschmidtX ($21.34 in chips) 
Seat 5: -=l Grek l=- ($45.27 in chips) 
Seat 6: W71W ($10 in chips) 
WI7ZZ: posts small blind $0.05
Ednhukm: posts big blind $0.10
*** HOLE CARDS ***
Dealt to WI7ZZ [3c 7s]
XXschmidtX: folds 
-=l Grek l=-: raises $0.15 to $0.25
W71W: folds 
Mr.Terek: folds 
WI7ZZ: folds 
Ednhukm: folds 
Uncalled bet ($0.15) returned to -=l Grek l=-
-=l Grek l=- collected $0.25 from pot
-=l Grek l=-: doesn't show hand 
*** SUMMARY ***
Total pot $0.25 | Rake $0 
Seat 1: Mr.Terek (button) folded before Flop (didn't bet)
Seat 2: WI7ZZ (small blind) folded before Flop
Seat 3: Ednhukm (big blind) folded before Flop
Seat 4: XXschmidtX folded before Flop (didn't bet)
Seat 5: -=l Grek l=- collected ($0.25)
Seat 6: W71W folded before Flop (didn't bet)



PokerStars Zoom Hand #188749675570:  Hold'em No Limit ($0.05/$0.10) - 2018/07/15 14:19:08 WET [2018/07/15 9:19:08 ET]
Table 'Aludra' 6-max Seat #1 is the button
Seat 1: Vespao20 ($18.91 in chips) 
Seat 2: Kummitaja ($11.28 in chips) 
Seat 3: kamikaza11 ($12.37 in chips) 
Seat 4: dzoint ($11.82 in chips) 
Seat 5: Eregne ($11.96 in chips) 
Seat 6: WI7ZZ ($10.49 in chips) 
Kummitaja: posts small blind $0.05
kamikaza11: posts big blind $0.10
*** HOLE CARDS ***
Dealt to WI7ZZ [6c 2c]
dzoint: raises $0.15 to $0.25
Eregne: folds 
WI7ZZ: folds 
Vespao20: folds 
Kummitaja: folds 
kamikaza11: folds 
Uncalled bet ($0.15) returned to dzoint
dzoint collected $0.25 from pot
dzoint: doesn't show hand 
*** SUMMARY ***
Total pot $0.25 | Rake $0 
Seat 1: Vespao20 (button) folded before Flop (didn't bet)
Seat 2: Kummitaja (small blind) folded before Flop
Seat 3: kamikaza11 (big blind) folded before Flop
Seat 4: dzoint collected ($0.25)
Seat 5: Eregne folded before Flop (didn't bet)
Seat 6: WI7ZZ folded before Flop (didn't bet)



PokerStars Zoom Hand #188749677611:  Hold'em No Limit ($0.05/$0.10) - 2018/07/15 14:19:12 WET [2018/07/15 9:19:12 ET]
Table 'Aludra' 6-max Seat #1 is the button
Seat 1: WI7ZZ ($10.44 in chips) 
Seat 2: PollyPeachum ($10.05 in chips) 
Seat 3: Cronus2013 ($10 in chips) 
Seat 4: michaltoja ($10 in chips) 
Seat 5: knullig ($8.28 in chips) 
Seat 6: shu1007 ($10.39 in chips) 
PollyPeachum: posts small blind $0.05
Cronus2013: posts big blind $0.10
*** HOLE CARDS ***
Dealt to WI7ZZ [Ah 2c]
michaltoja: raises $0.15 to $0.25
knullig: folds 
shu1007: folds 
WI7ZZ: calls $0.25
PollyPeachum: folds 
Cronus2013: folds 
*** FLOP *** [3h 7c 9d]
michaltoja: checks 
WI7ZZ: bets $0.24
michaltoja: folds 
Uncalled bet ($0.24) returned to WI7ZZ
WI7ZZ collected $0.62 from pot
WI7ZZ: doesn't show hand 
*** SUMMARY ***
Total pot $0.65 | Rake $0.03 
Board [3h 7c 9d]
Seat 1: WI7ZZ (button) collected ($0.62)
Seat 2: PollyPeachum (small blind) folded before Flop
Seat 3: Cronus2013 (big blind) folded before Flop
Seat 4: michaltoja folded on the Flop
Seat 5: knullig folded before Flop (didn't bet)
Seat 6: shu1007 folded before Flop (didn't bet)



PokerStars Zoom Hand #188749705496:  Hold'em No Limit ($0.05/$0.10) - 2018/07/15 14:20:06 WET [2018/07/15 9:20:06 ET]
Table 'Aludra' 6-max Seat #1 is the button
Seat 1: niqqa48 ($10 in chips) 
Seat 2: R2R2806 ($15.25 in chips) 
Seat 3: AlexDeLargee ($13.38 in chips) 
Seat 4: WI7ZZ ($10.81 in chips) 
Seat 5: hammerfish75 ($5.52 in chips) 
Seat 6: Spooks1337 ($28.67 in chips) 
R2R2806: posts small blind $0.05
AlexDeLargee: posts big blind $0.10
*** HOLE CARDS ***
Dealt to WI7ZZ [Ks 4c]
WI7ZZ: folds 
hammerfish75: folds 
Spooks1337: folds 
niqqa48: folds 
R2R2806: raises $0.15 to $0.25
AlexDeLargee: calls $0.15
*** FLOP *** [3s 3h Qd]
R2R2806: bets $0.48
AlexDeLargee: folds 
Uncalled bet ($0.48) returned to R2R2806
R2R2806 collected $0.48 from pot
R2R2806: doesn't show hand 
*** SUMMARY ***
Total pot $0.50 | Rake $0.02 
Board [3s 3h Qd]
Seat 1: niqqa48 (button) folded before Flop (didn't bet)
Seat 2: R2R2806 (small blind) collected ($0.48)
Seat 3: AlexDeLargee (big blind) folded on the Flop
Seat 4: WI7ZZ folded before Flop (didn't bet)
Seat 5: hammerfish75 folded before Flop (didn't bet)
Seat 6: Spooks1337 folded before Flop (didn't bet)



PokerStars Zoom Hand #188749708541:  Hold'em No Limit ($0.05/$0.10) - 2018/07/15 14:20:12 WET [2018/07/15 9:20:12 ET]
Table 'Aludra' 6-max Seat #1 is the button
Seat 1: bodriyar ($11.29 in chips) 
Seat 2: shnackattack ($7.52 in chips) 
Seat 3: mentaltony ($10.93 in chips) 
Seat 4: W71W ($10 in chips) 
Seat 5: WI7ZZ ($10.81 in chips) 
Seat 6: xabaza ($10.17 in chips) 
shnackattack: posts small blind $0.05
mentaltony: posts big blind $0.10
*** HOLE CARDS ***
Dealt to WI7ZZ [2h 9h]
W71W: folds 
WI7ZZ: folds 
xabaza: folds 
bodriyar: raises $0.20 to $0.30
shnackattack: folds 
mentaltony: folds 
Uncalled bet ($0.20) returned to bodriyar
bodriyar collected $0.25 from pot
bodriyar: doesn't show hand 
*** SUMMARY ***
Total pot $0.25 | Rake $0 
Seat 1: bodriyar (button) collected ($0.25)
Seat 2: shnackattack (small blind) folded before Flop
Seat 3: mentaltony (big blind) folded before Flop
Seat 4: W71W folded before Flop (didn't bet)
Seat 5: WI7ZZ folded before Flop (didn't bet)
Seat 6: xabaza folded before Flop (didn't bet)



PokerStars Zoom Hand #188749713165:  Hold'em No Limit ($0.05/$0.10) - 2018/07/15 14:20:21 WET [2018/07/15 9:20:21 ET]
Table 'Aludra' 6-max Seat #1 is the button
Seat 1: Heijden739 ($13.06 in chips) 
Seat 2: andremgremio ($10.41 in chips) 
Seat 3: WI7ZZ ($10.76 in chips) 
Seat 4: Hansestadt1910 ($34.97 in chips) 
Seat 5: shota315 ($10.86 in chips) 
Seat 6: cubadoo ($15.03 in chips) 
andremgremio: posts small blind $0.05
WI7ZZ: posts big blind $0.10
*** HOLE CARDS ***
Dealt to WI7ZZ [Ad 9c]
Hansestadt1910: raises $0.15 to $0.25
shota315: folds 
cubadoo: folds 
Heijden739: folds 
andremgremio: folds 
WI7ZZ: folds 
Uncalled bet ($0.15) returned to Hansestadt1910
Hansestadt1910 collected $0.25 from pot
Hansestadt1910: doesn't show hand 
*** SUMMARY ***
Total pot $0.25 | Rake $0 
Seat 1: Heijden739 (button) folded before Flop (didn't bet)
Seat 2: andremgremio (small blind) folded before Flop
Seat 3: WI7ZZ (big blind) folded before Flop
Seat 4: Hansestadt1910 collected ($0.25)
Seat 5: shota315 folded before Flop (didn't bet)
Seat 6: cubadoo folded before Flop (didn't bet)



PokerStars Zoom Hand #188749706985:  Hold'em No Limit ($0.05/$0.10) - 2018/07/15 14:20:09 WET [2018/07/15 9:20:09 ET]
Table 'Aludra' 6-max Seat #1 is the button
Seat 1: signofme ($12.18 in chips) 
Seat 2: miilio ($11.24 in chips) 
Seat 3: andypr0 ($31.18 in chips) 
Seat 4: WI7ZZ ($10.81 in chips) 
Seat 5: freeclimber6 ($14.40 in chips) 
Seat 6: andremgremio ($10.56 in chips) 
miilio: posts small blind $0.05
andypr0: posts big blind $0.10
*** HOLE CARDS ***
Dealt to WI7ZZ [9s 2d]
WI7ZZ: folds 
freeclimber6: folds 
andremgremio: folds 
signofme: raises $0.15 to $0.25
miilio: folds 
andypr0: calls $0.15
*** FLOP *** [Jc 6h 6d]
andypr0: checks 
signofme: checks 
*** TURN *** [Jc 6h 6d] [3h]
andypr0: bets $0.30
signofme: folds 
Uncalled bet ($0.30) returned to andypr0
andypr0 collected $0.53 from pot
andypr0: doesn't show hand 
*** SUMMARY ***
Total pot $0.55 | Rake $0.02 
Board [Jc 6h 6d 3h]
Seat 1: signofme (button) folded on the Turn
Seat 2: miilio (small blind) folded before Flop
Seat 3: andypr0 (big blind) collected ($0.53)
Seat 4: WI7ZZ folded before Flop (didn't bet)
Seat 5: freeclimber6 folded before Flop (didn't bet)
Seat 6: andremgremio folded before Flop (didn't bet)



PokerStars Zoom Hand #188749722553:  Hold'em No Limit ($0.05/$0.10) - 2018/07/15 14:20:39 WET [2018/07/15 9:20:39 ET]
Table 'Aludra' 6-max Seat #1 is the button
Seat 1: WI7ZZ ($10.66 in chips) 
Seat 2: NikkJr ($16.85 in chips) 
Seat 3: cubadoo ($11.89 in chips) 
Seat 4: impulsivo ($10.05 in chips) 
Seat 5: ChungkingExp ($26.65 in chips) 
Seat 6: incredibleuh ($5.83 in chips) 
NikkJr: posts small blind $0.05
cubadoo: posts big blind $0.10
*** HOLE CARDS ***
Dealt to WI7ZZ [4c 4h]
impulsivo: folds 
ChungkingExp: folds 
incredibleuh: folds 
WI7ZZ: raises $0.16 to $0.26
NikkJr: folds 
cubadoo: folds 
Uncalled bet ($0.16) returned to WI7ZZ
WI7ZZ collected $0.25 from pot
WI7ZZ: doesn't show hand 
*** SUMMARY ***
Total pot $0.25 | Rake $0 
Seat 1: WI7ZZ (button) collected ($0.25)
Seat 2: NikkJr (small blind) folded before Flop
Seat 3: cubadoo (big blind) folded before Flop
Seat 4: impulsivo folded before Flop (didn't bet)
Seat 5: ChungkingExp folded before Flop (didn't bet)
Seat 6: incredibleuh folded before Flop (didn't bet)



PokerStars Zoom Hand #188749710123:  Hold'em No Limit ($0.05/$0.10) - 2018/07/15 14:20:15 WET [2018/07/15 9:20:15 ET]
Table 'Aludra' 6-max Seat #1 is the button
Seat 1: AnHoCa ($11.28 in chips) 
Seat 2: WI7ZZ ($10.81 in chips) 
Seat 3: xabaza ($9.70 in chips) 
Seat 4: DIUK33 ($20.50 in chips) 
Seat 5: rest992 ($9.45 in chips) 
Seat 6: Ednhukm ($7.51 in chips) 
WI7ZZ: posts small blind $0.05
xabaza: posts big blind $0.10
*** HOLE CARDS ***
Dealt to WI7ZZ [Jc 5d]
DIUK33: folds 
rest992: raises $0.20 to $0.30
Ednhukm: calls $0.30
AnHoCa: folds 
WI7ZZ: folds 
xabaza: folds 
*** FLOP *** [4c 9h 2d]
rest992: bets $0.30
Ednhukm: calls $0.30
*** TURN *** [4c 9h 2d] [2h]
rest992: bets $0.50
Ednhukm: calls $0.50
*** RIVER *** [4c 9h 2d 2h] [6s]
rest992: checks 
Ednhukm: bets $1.19
rest992: calls $1.19
*** SHOW DOWN ***
Ednhukm: shows [Ad Ac] (two pair, Aces and Deuces)
rest992: mucks hand 
Ednhukm collected $4.52 from pot
*** SUMMARY ***
Total pot $4.73 | Rake $0.21 
Board [4c 9h 2d 2h 6s]
Seat 1: AnHoCa (button) folded before Flop (didn't bet)
Seat 2: WI7ZZ (small blind) folded before Flop
Seat 3: xabaza (big blind) folded before Flop
Seat 4: DIUK33 folded before Flop (didn't bet)
Seat 5: rest992 mucked [9s Ts]
Seat 6: Ednhukm showed [Ad Ac] and won ($4.52) with two pair, Aces and Deuces



PokerStars Zoom Hand #188749729164:  Hold'em No Limit ($0.05/$0.10) - 2018/07/15 14:20:52 WET [2018/07/15 9:20:52 ET]
Table 'Aludra' 6-max Seat #1 is the button
Seat 1: signofme ($14.21 in chips) 
Seat 2: inglorious6 ($14.02 in chips) 
Seat 3: Don'tFoldBB ($10 in chips) 
Seat 4: WI7ZZ ($10.81 in chips) 
Seat 5: Dalibomba ($13.53 in chips) 
Seat 6: mikitok ($20.55 in chips) 
inglorious6: posts small blind $0.05
Don'tFoldBB: posts big blind $0.10
*** HOLE CARDS ***
Dealt to WI7ZZ [Jc 8h]
WI7ZZ: folds 
Dalibomba: folds 
mikitok: folds 
signofme: raises $0.15 to $0.25
inglorious6: folds 
Don'tFoldBB: folds 
Uncalled bet ($0.15) returned to signofme
signofme collected $0.25 from pot
signofme: doesn't show hand 
*** SUMMARY ***
Total pot $0.25 | Rake $0 
Seat 1: signofme (button) collected ($0.25)
Seat 2: inglorious6 (small blind) folded before Flop
Seat 3: Don'tFoldBB (big blind) folded before Flop
Seat 4: WI7ZZ folded before Flop (didn't bet)
Seat 5: Dalibomba folded before Flop (didn't bet)
Seat 6: mikitok folded before Flop (didn't bet)



PokerStars Zoom Hand #188749719394:  Hold'em No Limit ($0.05/$0.10) - 2018/07/15 14:20:33 WET [2018/07/15 9:20:33 ET]
Table 'Aludra' 6-max Seat #1 is the button
Seat 1: kazyunok ($7.88 in chips) 
Seat 2: alfa846 ($12.93 in chips) 
Seat 3: Dan0505 ($3.75 in chips) 
Seat 4: Don'tFoldBB ($10.27 in chips) 
Seat 5: WI7ZZ ($10.66 in chips) 
Seat 6: naymaierbra ($12.47 in chips) 
alfa846: posts small blind $0.05
Dan0505: posts big blind $0.10
*** HOLE CARDS ***
Dealt to WI7ZZ [8s 2h]
Don'tFoldBB: raises $0.15 to $0.25
WI7ZZ: folds 
naymaierbra: folds 
kazyunok: folds 
alfa846: folds 
Dan0505: calls $0.15
*** FLOP *** [Jc 5h 6d]
Dan0505: checks 
Don'tFoldBB: bets $0.29
Dan0505: calls $0.29
*** TURN *** [Jc 5h 6d] [As]
Dan0505: checks 
Don'tFoldBB: bets $0.70
Dan0505: calls $0.70
*** RIVER *** [Jc 5h 6d As] [Qh]
Dan0505: checks 
Don'tFoldBB: checks 
*** SHOW DOWN ***
Dan0505: shows [9s 6h] (a pair of Sixes)
Don'tFoldBB: shows [Kh Ac] (a pair of Aces)
Don'tFoldBB collected $2.42 from pot
*** SUMMARY ***
Total pot $2.53 | Rake $0.11 
Board [Jc 5h 6d As Qh]
Seat 1: kazyunok (button) folded before Flop (didn't bet)
Seat 2: alfa846 (small blind) folded before Flop
Seat 3: Dan0505 (big blind) showed [9s 6h] and lost with a pair of Sixes
Seat 4: Don'tFoldBB showed [Kh Ac] and won ($2.42) with a pair of Aces
Seat 5: WI7ZZ folded before Flop (didn't bet)
Seat 6: naymaierbra folded before Flop (didn't bet)



PokerStars Zoom Hand #188749730703:  Hold'em No Limit ($0.05/$0.10) - 2018/07/15 14:20:55 WET [2018/07/15 9:20:55 ET]
Table 'Aludra' 6-max Seat #1 is the button
Seat 1: impulsivo ($21.89 in chips) 
Seat 2: WI7ZZ ($10.81 in chips) 
Seat 3: Gevron ($38.25 in chips) 
Seat 4: KartenBob0815 ($19.17 in chips) 
Seat 5: ChungkingExp ($12.88 in chips) 
Seat 6: naymaierbra ($10.89 in chips) 
WI7ZZ: posts small blind $0.05
Gevron: posts big blind $0.10
*** HOLE CARDS ***
Dealt to WI7ZZ [Ac Tc]
KartenBob0815: folds 
ChungkingExp: folds 
naymaierbra: folds 
impulsivo: folds 
WI7ZZ: raises $0.21 to $0.31
Gevron: folds 
Uncalled bet ($0.21) returned to WI7ZZ
WI7ZZ collected $0.20 from pot
WI7ZZ: doesn't show hand 
*** SUMMARY ***
Total pot $0.20 | Rake $0 
Seat 1: impulsivo (button) folded before Flop (didn't bet)
Seat 2: WI7ZZ (small blind) collected ($0.20)
Seat 3: Gevron (big blind) folded before Flop
Seat 4: KartenBob0815 folded before Flop (didn't bet)
Seat 5: ChungkingExp folded before Flop (didn't bet)
Seat 6: naymaierbra folded before Flop (didn't bet)



PokerStars Zoom Hand #188749720951:  Hold'em No Limit ($0.05/$0.10) - 2018/07/15 14:20:36 WET [2018/07/15 9:20:36 ET]
Table 'Aludra' 6-max Seat #1 is the button
Seat 1: GuiBenites ($11.66 in chips) 
Seat 2: -=l Grek l=- ($45.42 in chips) 
Seat 3: dzoint ($10.06 in chips) 
Seat 4: malotou ($8.32 in chips) 
Seat 5: AlexDeLargee ($10 in chips) 
Seat 6: WI7ZZ ($10.66 in chips) 
-=l Grek l=-: posts small blind $0.05
dzoint: posts big blind $0.10
*** HOLE CARDS ***
Dealt to WI7ZZ [4h 3c]
malotou: raises $0.20 to $0.30
AlexDeLargee: folds 
WI7ZZ: folds 
GuiBenites: folds 
-=l Grek l=-: folds 
dzoint: calls $0.20
*** FLOP *** [Js Kc 8s]
dzoint: checks 
malotou: checks 
*** TURN *** [Js Kc 8s] [2h]
dzoint: bets $0.30
malotou: calls $0.30
*** RIVER *** [Js Kc 8s 2h] [3s]
dzoint: bets $0.74
malotou: calls $0.74
*** SHOW DOWN ***
dzoint: shows [Qc Ah] (high card Ace)
malotou: shows [9h 9c] (a pair of Nines)
malotou collected $2.61 from pot
*** SUMMARY ***
Total pot $2.73 | Rake $0.12 
Board [Js Kc 8s 2h 3s]
Seat 1: GuiBenites (button) folded before Flop (didn't bet)
Seat 2: -=l Grek l=- (small blind) folded before Flop
Seat 3: dzoint (big blind) showed [Qc Ah] and lost with high card Ace
Seat 4: malotou showed [9h 9c] and won ($2.61) with a pair of Nines
Seat 5: AlexDeLargee folded before Flop (didn't bet)
Seat 6: WI7ZZ folded before Flop (didn't bet)



PokerStars Zoom Hand #188749739977:  Hold'em No Limit ($0.05/$0.10) - 2018/07/15 14:21:13 WET [2018/07/15 9:21:13 ET]
Table 'Aludra' 6-max Seat #1 is the button
Seat 1: Andreas.P305 ($14.59 in chips) 
Seat 2: Sergdoc71rus ($3.90 in chips) 
Seat 3: WI7ZZ ($10.91 in chips) 
Seat 4: ninavrata 86 ($10.05 in chips) 
Seat 5: Anton93726 ($9.85 in chips) 
Seat 6: kazyunok ($7.24 in chips) 
Sergdoc71rus: posts small blind $0.05
WI7ZZ: posts big blind $0.10
*** HOLE CARDS ***
Dealt to WI7ZZ [2s Ks]
ninavrata 86: folds 
Anton93726: raises $0.20 to $0.30
kazyunok: folds 
Andreas.P305: folds 
Sergdoc71rus: folds 
WI7ZZ: folds 
Uncalled bet ($0.20) returned to Anton93726
Anton93726 collected $0.25 from pot
*** SUMMARY ***
Total pot $0.25 | Rake $0 
Seat 1: Andreas.P305 (button) folded before Flop (didn't bet)
Seat 2: Sergdoc71rus (small blind) folded before Flop
Seat 3: WI7ZZ (big blind) folded before Flop
Seat 4: ninavrata 86 folded before Flop (didn't bet)
Seat 5: Anton93726 collected ($0.25)
Seat 6: kazyunok folded before Flop (didn't bet)



PokerStars Zoom Hand #188749746661:  Hold'em No Limit ($0.05/$0.10) - 2018/07/15 14:21:26 WET [2018/07/15 9:21:26 ET]
Table 'Aludra' 6-max Seat #1 is the button
Seat 1: WI7ZZ ($10.81 in chips) 
Seat 2: SickDayNight ($16.82 in chips) 
Seat 3: fillette789 ($8.91 in chips) 
Seat 4: donghatimpy ($10.45 in chips) 
Seat 5: kamikaza11 ($13.10 in chips) 
Seat 6: actionMoon ($20.24 in chips) 
SickDayNight: posts small blind $0.05
fillette789: posts big blind $0.10
*** HOLE CARDS ***
Dealt to WI7ZZ [3d 6h]
donghatimpy: folds 
kamikaza11: folds 
actionMoon: folds 
WI7ZZ: folds 
SickDayNight: folds 
Uncalled bet ($0.05) returned to fillette789
fillette789 collected $0.10 from pot
fillette789: doesn't show hand 
*** SUMMARY ***
Total pot $0.10 | Rake $0 
Seat 1: WI7ZZ (button) folded before Flop (didn't bet)
Seat 2: SickDayNight (small blind) folded before Flop
Seat 3: fillette789 (big blind) collected ($0.10)
Seat 4: donghatimpy folded before Flop (didn't bet)
Seat 5: kamikaza11 folded before Flop (didn't bet)
Seat 6: actionMoon folded before Flop (didn't bet)



PokerStars Zoom Hand #188749749745:  Hold'em No Limit ($0.05/$0.10) - 2018/07/15 14:21:32 WET [2018/07/15 9:21:32 ET]
Table 'Aludra' 6-max Seat #1 is the button
Seat 1: KartenBob0815 ($19.02 in chips) 
Seat 2: GROM84 ($21.06 in chips) 
Seat 3: blasterrrtje ($12.71 in chips) 
Seat 4: AlexDeLargee ($12.63 in chips) 
Seat 5: Diamond-PL ($10.33 in chips) 
Seat 6: WI7ZZ ($10.81 in chips) 
GROM84: posts small blind $0.05
blasterrrtje: posts big blind $0.10
*** HOLE CARDS ***
Dealt to WI7ZZ [6c 7s]
AlexDeLargee: folds 
Diamond-PL: raises $0.20 to $0.30
WI7ZZ: folds 
KartenBob0815: folds 
GROM84: folds 
blasterrrtje: folds 
Uncalled bet ($0.20) returned to Diamond-PL
Diamond-PL collected $0.25 from pot
Diamond-PL: doesn't show hand 
*** SUMMARY ***
Total pot $0.25 | Rake $0 
Seat 1: KartenBob0815 (button) folded before Flop (didn't bet)
Seat 2: GROM84 (small blind) folded before Flop
Seat 3: blasterrrtje (big blind) folded before Flop
Seat 4: AlexDeLargee folded before Flop (didn't bet)
Seat 5: Diamond-PL collected ($0.25)
Seat 6: WI7ZZ folded before Flop (didn't bet)



PokerStars Zoom Hand #188749748200:  Hold'em No Limit ($0.05/$0.10) - 2018/07/15 14:21:29 WET [2018/07/15 9:21:29 ET]
Table 'Aludra' 6-max Seat #1 is the button
Seat 1: Rude8oy9 ($24.08 in chips) 
Seat 2: xabaza ($10.47 in chips) 
Seat 3: R2R2806 ($11.78 in chips) 
Seat 4: kamikaza11 ($13.10 in chips) 
Seat 5: WI7ZZ ($10.81 in chips) 
Seat 6: michaltoja ($20.48 in chips) 
xabaza: posts small blind $0.05
R2R2806: posts big blind $0.10
*** HOLE CARDS ***
Dealt to WI7ZZ [Tc 2c]
kamikaza11: raises $0.20 to $0.30
WI7ZZ: folds 
michaltoja: folds 
Rude8oy9: folds 
xabaza: folds 
R2R2806: folds 
Uncalled bet ($0.20) returned to kamikaza11
kamikaza11 collected $0.25 from pot
kamikaza11: doesn't show hand 
*** SUMMARY ***
Total pot $0.25 | Rake $0 
Seat 1: Rude8oy9 (button) folded before Flop (didn't bet)
Seat 2: xabaza (small blind) folded before Flop
Seat 3: R2R2806 (big blind) folded before Flop
Seat 4: kamikaza11 collected ($0.25)
Seat 5: WI7ZZ folded before Flop (didn't bet)
Seat 6: michaltoja folded before Flop (didn't bet)



PokerStars Zoom Hand #188749751309:  Hold'em No Limit ($0.05/$0.10) - 2018/07/15 14:21:35 WET [2018/07/15 9:21:35 ET]
Table 'Aludra' 6-max Seat #1 is the button
Seat 1: m_carrillo89 ($10 in chips) 
Seat 2: michaltoja ($14.26 in chips) 
Seat 3: -=l Grek l=- ($13.84 in chips) 
Seat 4: maxbut56 ($9.16 in chips) 
Seat 5: WI7ZZ ($10.81 in chips) 
Seat 6: Vespao20 ($10 in chips) 
michaltoja: posts small blind $0.05
-=l Grek l=-: posts big blind $0.10
*** HOLE CARDS ***
Dealt to WI7ZZ [9d 8h]
maxbut56: folds 
WI7ZZ: folds 
Vespao20: folds 
m_carrillo89: raises $0.20 to $0.30
michaltoja: folds 
-=l Grek l=-: folds 
Uncalled bet ($0.20) returned to m_carrillo89
m_carrillo89 collected $0.25 from pot
m_carrillo89: doesn't show hand 
*** SUMMARY ***
Total pot $0.25 | Rake $0 
Seat 1: m_carrillo89 (button) collected ($0.25)
Seat 2: michaltoja (small blind) folded before Flop
Seat 3: -=l Grek l=- (big blind) folded before Flop
Seat 4: maxbut56 folded before Flop (didn't bet)
Seat 5: WI7ZZ folded before Flop (didn't bet)
Seat 6: Vespao20 folded before Flop (didn't bet)



PokerStars Zoom Hand #188749763256:  Hold'em No Limit ($0.05/$0.10) - 2018/07/15 14:21:58 WET [2018/07/15 9:21:58 ET]
Table 'Aludra' 6-max Seat #1 is the button
Seat 1: Jack123985 ($10.41 in chips) 
Seat 2: WI7ZZ ($10.71 in chips) 
Seat 3: Goudanou ($5.89 in chips) 
Seat 4: m_carrillo89 ($10.15 in chips) 
Seat 5: NikkJr ($18.86 in chips) 
Seat 6: kazyunok ($8.08 in chips) 
WI7ZZ: posts small blind $0.05
Goudanou: posts big blind $0.10
*** HOLE CARDS ***
Dealt to WI7ZZ [Qh 8h]
m_carrillo89: folds 
NikkJr: folds 
kazyunok: folds 
Jack123985: folds 
WI7ZZ: raises $0.16 to $0.26
Goudanou: folds 
Uncalled bet ($0.16) returned to WI7ZZ
WI7ZZ collected $0.20 from pot
WI7ZZ: doesn't show hand 
*** SUMMARY ***
Total pot $0.20 | Rake $0 
Seat 1: Jack123985 (button) folded before Flop (didn't bet)
Seat 2: WI7ZZ (small blind) collected ($0.20)
Seat 3: Goudanou (big blind) folded before Flop
Seat 4: m_carrillo89 folded before Flop (didn't bet)
Seat 5: NikkJr folded before Flop (didn't bet)
Seat 6: kazyunok folded before Flop (didn't bet)



PokerStars Zoom Hand #188749771045:  Hold'em No Limit ($0.05/$0.10) - 2018/07/15 14:22:13 WET [2018/07/15 9:22:13 ET]
Table 'Aludra' 6-max Seat #1 is the button
Seat 1: WI7ZZ ($10.81 in chips) 
Seat 2: shota315 ($10.36 in chips) 
Seat 3: Diamond-PL ($10.43 in chips) 
Seat 4: universe123 ($9.33 in chips) 
Seat 5: incredibleuh ($5.62 in chips) 
Seat 6: CafeDay ($10 in chips) 
shota315: posts small blind $0.05
Diamond-PL: posts big blind $0.10
*** HOLE CARDS ***
Dealt to WI7ZZ [5d Ad]
universe123: folds 
incredibleuh: folds 
CafeDay: folds 
WI7ZZ: raises $0.16 to $0.26
shota315: folds 
Diamond-PL: folds 
Uncalled bet ($0.16) returned to WI7ZZ
WI7ZZ collected $0.25 from pot
WI7ZZ: doesn't show hand 
*** SUMMARY ***
Total pot $0.25 | Rake $0 
Seat 1: WI7ZZ (button) collected ($0.25)
Seat 2: shota315 (small blind) folded before Flop
Seat 3: Diamond-PL (big blind) folded before Flop
Seat 4: universe123 folded before Flop (didn't bet)
Seat 5: incredibleuh folded before Flop (didn't bet)
Seat 6: CafeDay folded before Flop (didn't bet)



PokerStars Zoom Hand #188749754507:  Hold'em No Limit ($0.05/$0.10) - 2018/07/15 14:21:41 WET [2018/07/15 9:21:41 ET]
Table 'Aludra' 6-max Seat #1 is the button
Seat 1: Circenses_p ($7.13 in chips) 
Seat 2: anthony1480 ($4.53 in chips) 
Seat 3: WI7ZZ ($10.81 in chips) 
Seat 4: GROM84 ($21.01 in chips) 
Seat 5: Vespao20 ($10 in chips) 
Seat 6: Rude8oy9 ($24.08 in chips) 
anthony1480: posts small blind $0.05
WI7ZZ: posts big blind $0.10
*** HOLE CARDS ***
Dealt to WI7ZZ [8d 2h]
GROM84: raises $0.20 to $0.30
Vespao20: folds 
Rude8oy9: raises $0.60 to $0.90
Circenses_p: calls $0.90
anthony1480: folds 
WI7ZZ: folds 
GROM84: calls $0.60
*** FLOP *** [Qh Qc Ks]
GROM84: checks 
Rude8oy9: checks 
Circenses_p: checks 
*** TURN *** [Qh Qc Ks] [9d]
GROM84: checks 
Rude8oy9: bets $1.28
Circenses_p: folds 
GROM84: folds 
Uncalled bet ($1.28) returned to Rude8oy9
Rude8oy9 collected $2.72 from pot
Rude8oy9: doesn't show hand 
*** SUMMARY ***
Total pot $2.85 | Rake $0.13 
Board [Qh Qc Ks 9d]
Seat 1: Circenses_p (button) folded on the Turn
Seat 2: anthony1480 (small blind) folded before Flop
Seat 3: WI7ZZ (big blind) folded before Flop
Seat 4: GROM84 folded on the Turn
Seat 5: Vespao20 folded before Flop (didn't bet)
Seat 6: Rude8oy9 collected ($2.72)



PokerStars Zoom Hand #188749752904:  Hold'em No Limit ($0.05/$0.10) - 2018/07/15 14:21:38 WET [2018/07/15 9:21:38 ET]
Table 'Aludra' 6-max Seat #1 is the button
Seat 1: ultra radi ($13.34 in chips) 
Seat 2: iDecMate ($10.74 in chips) 
Seat 3: Dragonslyer1337 ($14.70 in chips) 
Seat 4: WI7ZZ ($10.81 in chips) 
Seat 5: Predtecha87 ($12.85 in chips) 
Seat 6: Hy6uK55 ($11.91 in chips) 
iDecMate: posts small blind $0.05
Dragonslyer1337: posts big blind $0.10
*** HOLE CARDS ***
Dealt to WI7ZZ [8s 9d]
WI7ZZ: folds 
Predtecha87: folds 
Hy6uK55: raises $0.20 to $0.30
ultra radi: folds 
iDecMate: folds 
Dragonslyer1337: calls $0.20
*** FLOP *** [Jc 4d Js]
Dragonslyer1337: checks 
Hy6uK55: bets $0.35
Dragonslyer1337: calls $0.35
*** TURN *** [Jc 4d Js] [Jh]
Dragonslyer1337: checks 
Hy6uK55: bets $0.53
Dragonslyer1337: calls $0.53
*** RIVER *** [Jc 4d Js Jh] [Th]
Dragonslyer1337: checks 
Hy6uK55: checks 
*** SHOW DOWN ***
Dragonslyer1337: shows [Jd 8d] (four of a kind, Jacks)
Hy6uK55: mucks hand 
Dragonslyer1337 collected $2.30 from pot
*** SUMMARY ***
Total pot $2.41 | Rake $0.11 
Board [Jc 4d Js Jh Th]
Seat 1: ultra radi (button) folded before Flop (didn't bet)
Seat 2: iDecMate (small blind) folded before Flop
Seat 3: Dragonslyer1337 (big blind) showed [Jd 8d] and won ($2.30) with four of a kind, Jacks
Seat 4: WI7ZZ folded before Flop (didn't bet)
Seat 5: Predtecha87 folded before Flop (didn't bet)
Seat 6: Hy6uK55 mucked [Kh As]



PokerStars Zoom Hand #188749780538:  Hold'em No Limit ($0.05/$0.10) - 2018/07/15 14:22:31 WET [2018/07/15 9:22:31 ET]
Table 'Aludra' 6-max Seat #1 is the button
Seat 1: crvckers ($11.88 in chips) 
Seat 2: LukksAA ($12.57 in chips) 
Seat 3: ValiumJJ ($18.70 in chips) 
Seat 4: universe123 ($9.41 in chips) 
Seat 5: paya0809 ($10 in chips) 
Seat 6: WI7ZZ ($10.96 in chips) 
LukksAA: posts small blind $0.05
ValiumJJ: posts big blind $0.10
*** HOLE CARDS ***
Dealt to WI7ZZ [Jd Kd]
universe123: folds 
paya0809: folds 
WI7ZZ: raises $0.21 to $0.31
crvckers: calls $0.31
LukksAA: raises $1.09 to $1.40
ValiumJJ: folds 
WI7ZZ: folds 
crvckers: calls $1.09
*** FLOP *** [Ad 8c 2d]
LukksAA: checks 
crvckers: checks 
*** TURN *** [Ad 8c 2d] [Qs]
LukksAA: checks 
crvckers: bets $2
LukksAA: folds 
Uncalled bet ($2) returned to crvckers
crvckers collected $3.07 from pot
crvckers: doesn't show hand 
*** SUMMARY ***
Total pot $3.21 | Rake $0.14 
Board [Ad 8c 2d Qs]
Seat 1: crvckers (button) collected ($3.07)
Seat 2: LukksAA (small blind) folded on the Turn
Seat 3: ValiumJJ (big blind) folded before Flop
Seat 4: universe123 folded before Flop (didn't bet)
Seat 5: paya0809 folded before Flop (didn't bet)
Seat 6: WI7ZZ folded before Flop



PokerStars Zoom Hand #188749843431:  Hold'em No Limit ($0.05/$0.10) - 2018/07/15 14:24:32 WET [2018/07/15 9:24:32 ET]
Table 'Aludra' 6-max Seat #1 is the button
Seat 1: Tcanarchy ($29.86 in chips) 
Seat 2: ninavrata 86 ($10.46 in chips) 
Seat 3: WI7ZZ ($10.60 in chips) 
Seat 4: R2R2806 ($29.40 in chips) 
Seat 5: W71W ($10 in chips) 
Seat 6: -=l Grek l=- ($17.40 in chips) 
ninavrata 86: posts small blind $0.05
WI7ZZ: posts big blind $0.10
*** HOLE CARDS ***
Dealt to WI7ZZ [9d 2s]
R2R2806: folds 
W71W: folds 
-=l Grek l=-: folds 
Tcanarchy: folds 
ninavrata 86: folds 
Uncalled bet ($0.05) returned to WI7ZZ
WI7ZZ collected $0.10 from pot
WI7ZZ: doesn't show hand 
*** SUMMARY ***
Total pot $0.10 | Rake $0 
Seat 1: Tcanarchy (button) folded before Flop (didn't bet)
Seat 2: ninavrata 86 (small blind) folded before Flop
Seat 3: WI7ZZ (big blind) collected ($0.10)
Seat 4: R2R2806 folded before Flop (didn't bet)
Seat 5: W71W folded before Flop (didn't bet)
Seat 6: -=l Grek l=- folded before Flop (didn't bet)



PokerStars Zoom Hand #188749839676:  Hold'em No Limit ($0.05/$0.10) - 2018/07/15 14:24:25 WET [2018/07/15 9:24:25 ET]
Table 'Aludra' 6-max Seat #1 is the button
Seat 1: kaisen75 ($10 in chips) 
Seat 2: WI7ZZ ($10.65 in chips) 
Seat 3: TestaDiCazz ($10.62 in chips) 
Seat 4: iDecMate ($10.64 in chips) 
Seat 5: Rubbernicks ($12.63 in chips) 
Seat 6: Juurikas ($14.90 in chips) 
WI7ZZ: posts small blind $0.05
TestaDiCazz: posts big blind $0.10
*** HOLE CARDS ***
Dealt to WI7ZZ [6c 8d]
iDecMate: folds 
Rubbernicks: folds 
Juurikas: folds 
kaisen75: raises $0.10 to $0.20
WI7ZZ: folds 
TestaDiCazz: calls $0.10
*** FLOP *** [9c 8c Ad]
TestaDiCazz: checks 
kaisen75: bets $0.32
TestaDiCazz: folds 
Uncalled bet ($0.32) returned to kaisen75
kaisen75 collected $0.43 from pot
kaisen75: doesn't show hand 
*** SUMMARY ***
Total pot $0.45 | Rake $0.02 
Board [9c 8c Ad]
Seat 1: kaisen75 (button) collected ($0.43)
Seat 2: WI7ZZ (small blind) folded before Flop
Seat 3: TestaDiCazz (big blind) folded on the Flop
Seat 4: iDecMate folded before Flop (didn't bet)
Seat 5: Rubbernicks folded before Flop (didn't bet)
Seat 6: Juurikas folded before Flop (didn't bet)



PokerStars Zoom Hand #188749852746:  Hold'em No Limit ($0.05/$0.10) - 2018/07/15 14:24:50 WET [2018/07/15 9:24:50 ET]
Table 'Aludra' 6-max Seat #1 is the button
Seat 1: g.kotzas ($11.24 in chips) 
Seat 2: TestaDiCazz ($10.42 in chips) 
Seat 3: mentaltony ($22.99 in chips) 
Seat 4: WI7ZZ ($10.65 in chips) 
Seat 5: shu1007 ($10.60 in chips) 
Seat 6: bradm195 ($15 in chips) 
TestaDiCazz: posts small blind $0.05
mentaltony: posts big blind $0.10
*** HOLE CARDS ***
Dealt to WI7ZZ [Jc 4h]
WI7ZZ: folds 
shu1007: raises $0.20 to $0.30
bradm195: folds 
g.kotzas: folds 
TestaDiCazz: folds 
mentaltony: folds 
Uncalled bet ($0.20) returned to shu1007
shu1007 collected $0.25 from pot
shu1007: doesn't show hand 
*** SUMMARY ***
Total pot $0.25 | Rake $0 
Seat 1: g.kotzas (button) folded before Flop (didn't bet)
Seat 2: TestaDiCazz (small blind) folded before Flop
Seat 3: mentaltony (big blind) folded before Flop
Seat 4: WI7ZZ folded before Flop (didn't bet)
Seat 5: shu1007 collected ($0.25)
Seat 6: bradm195 folded before Flop (didn't bet)



PokerStars Zoom Hand #188749854249:  Hold'em No Limit ($0.05/$0.10) - 2018/07/15 14:24:53 WET [2018/07/15 9:24:53 ET]
Table 'Aludra' 6-max Seat #1 is the button
Seat 1: WI7ZZ ($10.65 in chips) 
Seat 2: BBQ222 ($19.09 in chips) 
Seat 3: Dalibomba ($12.56 in chips) 
Seat 4: malotou ($9.71 in chips) 
Seat 5: kamikaza11 ($16.49 in chips) 
Seat 6: Gevron ($32.91 in chips) 
BBQ222: posts small blind $0.05
Dalibomba: posts big blind $0.10
*** HOLE CARDS ***
Dealt to WI7ZZ [4s 3s]
malotou: folds 
kamikaza11: folds 
Gevron: folds 
WI7ZZ: raises $0.21 to $0.31
BBQ222: folds 
Dalibomba: folds 
Uncalled bet ($0.21) returned to WI7ZZ
WI7ZZ collected $0.25 from pot
WI7ZZ: doesn't show hand 
*** SUMMARY ***
Total pot $0.25 | Rake $0 
Seat 1: WI7ZZ (button) collected ($0.25)
Seat 2: BBQ222 (small blind) folded before Flop
Seat 3: Dalibomba (big blind) folded before Flop
Seat 4: malotou folded before Flop (didn't bet)
Seat 5: kamikaza11 folded before Flop (didn't bet)
Seat 6: Gevron folded before Flop (didn't bet)



PokerStars Zoom Hand #188749841893:  Hold'em No Limit ($0.05/$0.10) - 2018/07/15 14:24:29 WET [2018/07/15 9:24:29 ET]
Table 'Aludra' 6-max Seat #1 is the button
Seat 1: LukksAA ($11.17 in chips) 
Seat 2: m_carrillo89 ($10.05 in chips) 
Seat 3: cergo18 ($29.88 in chips) 
Seat 4: Don'tFoldBB ($11.82 in chips) 
Seat 5: WI7ZZ ($10.60 in chips) 
Seat 6: jb112358 ($16.82 in chips) 
m_carrillo89: posts small blind $0.05
cergo18: posts big blind $0.10
*** HOLE CARDS ***
Dealt to WI7ZZ [6s 4d]
Don'tFoldBB: folds 
WI7ZZ: folds 
jb112358: raises $0.15 to $0.25
LukksAA: folds 
m_carrillo89: folds 
cergo18: calls $0.15
*** FLOP *** [8h 2c 3s]
cergo18: bets $0.27
jb112358: raises $0.63 to $0.90
cergo18: calls $0.63
*** TURN *** [8h 2c 3s] [Jh]
cergo18: checks 
jb112358: bets $1.60
cergo18: folds 
Uncalled bet ($1.60) returned to jb112358
jb112358 collected $2.24 from pot
jb112358: doesn't show hand 
*** SUMMARY ***
Total pot $2.35 | Rake $0.11 
Board [8h 2c 3s Jh]
Seat 1: LukksAA (button) folded before Flop (didn't bet)
Seat 2: m_carrillo89 (small blind) folded before Flop
Seat 3: cergo18 (big blind) folded on the Turn
Seat 4: Don'tFoldBB folded before Flop (didn't bet)
Seat 5: WI7ZZ folded before Flop (didn't bet)
Seat 6: jb112358 collected ($2.24)



PokerStars Zoom Hand #188749863036:  Hold'em No Limit ($0.05/$0.10) - 2018/07/15 14:25:10 WET [2018/07/15 9:25:10 ET]
Table 'Aludra' 6-max Seat #1 is the button
Seat 1: Bybbo1331 ($9.05 in chips) 
Seat 2: iDecMate ($10 in chips) 
Seat 3: Toxa512 ($11.79 in chips) 
Seat 4: xabaza ($10.25 in chips) 
Seat 5: inglorious6 ($14.80 in chips) 
Seat 6: WI7ZZ ($10.80 in chips) 
iDecMate: posts small blind $0.05
Toxa512: posts big blind $0.10
*** HOLE CARDS ***
Dealt to WI7ZZ [4d 5d]
xabaza: folds 
inglorious6: folds 
WI7ZZ: raises $0.21 to $0.31
Bybbo1331: calls $0.31
iDecMate: folds 
Toxa512: calls $0.21
*** FLOP *** [9h Jh Th]
Toxa512: checks 
WI7ZZ: checks 
Bybbo1331: checks 
*** TURN *** [9h Jh Th] [Qc]
Toxa512: checks 
WI7ZZ: checks 
Bybbo1331: bets $0.94
Toxa512: folds 
WI7ZZ: folds 
Uncalled bet ($0.94) returned to Bybbo1331
Bybbo1331 collected $0.94 from pot
*** SUMMARY ***
Total pot $0.98 | Rake $0.04 
Board [9h Jh Th Qc]
Seat 1: Bybbo1331 (button) collected ($0.94)
Seat 2: iDecMate (small blind) folded before Flop
Seat 3: Toxa512 (big blind) folded on the Turn
Seat 4: xabaza folded before Flop (didn't bet)
Seat 5: inglorious6 folded before Flop (didn't bet)
Seat 6: WI7ZZ folded on the Turn



PokerStars Zoom Hand #188749880181:  Hold'em No Limit ($0.05/$0.10) - 2018/07/15 14:25:43 WET [2018/07/15 9:25:43 ET]
Table 'Aludra' 6-max Seat #1 is the button
Seat 1: CafeDay ($10.53 in chips) 
Seat 2: WI7ZZ ($10.49 in chips) 
Seat 3: scotseng ($17.73 in chips) 
Seat 4: colonel_nsk ($13.24 in chips) 
Seat 5: padde886 ($21.88 in chips) 
Seat 6: done306 ($10.66 in chips) 
WI7ZZ: posts small blind $0.05
scotseng: posts big blind $0.10
*** HOLE CARDS ***
Dealt to WI7ZZ [4s 2c]
colonel_nsk: folds 
padde886: folds 
done306: raises $0.20 to $0.30
CafeDay: folds 
WI7ZZ: folds 
scotseng: folds 
Uncalled bet ($0.20) returned to done306
done306 collected $0.25 from pot
done306: doesn't show hand 
*** SUMMARY ***
Total pot $0.25 | Rake $0 
Seat 1: CafeDay (button) folded before Flop (didn't bet)
Seat 2: WI7ZZ (small blind) folded before Flop
Seat 3: scotseng (big blind) folded before Flop
Seat 4: colonel_nsk folded before Flop (didn't bet)
Seat 5: padde886 folded before Flop (didn't bet)
Seat 6: done306 collected ($0.25)



PokerStars Zoom Hand #188749886431:  Hold'em No Limit ($0.05/$0.10) - 2018/07/15 14:25:55 WET [2018/07/15 9:25:55 ET]
Table 'Aludra' 6-max Seat #1 is the button
Seat 1: -=l Grek l=- ($45.46 in chips) 
Seat 2: jinn171700 ($8.96 in chips) 
Seat 3: WI7ZZ ($10.44 in chips) 
Seat 4: ume1234 ($26.91 in chips) 
Seat 5: Spooks1337 ($26.30 in chips) 
Seat 6: ShellysAshes ($14.66 in chips) 
jinn171700: posts small blind $0.05
WI7ZZ: posts big blind $0.10
*** HOLE CARDS ***
Dealt to WI7ZZ [7c Js]
ume1234: raises $0.20 to $0.30
Spooks1337: folds 
ShellysAshes: folds 
-=l Grek l=-: folds 
jinn171700: folds 
WI7ZZ: folds 
Uncalled bet ($0.20) returned to ume1234
ume1234 collected $0.25 from pot
*** SUMMARY ***
Total pot $0.25 | Rake $0 
Seat 1: -=l Grek l=- (button) folded before Flop (didn't bet)
Seat 2: jinn171700 (small blind) folded before Flop
Seat 3: WI7ZZ (big blind) folded before Flop
Seat 4: ume1234 collected ($0.25)
Seat 5: Spooks1337 folded before Flop (didn't bet)
Seat 6: ShellysAshes folded before Flop (didn't bet)



PokerStars Zoom Hand #188749892169:  Hold'em No Limit ($0.05/$0.10) - 2018/07/15 14:26:06 WET [2018/07/15 9:26:06 ET]
Table 'Aludra' 6-max Seat #1 is the button
Seat 1: kamikaza11 ($25.31 in chips) 
Seat 2: Andra.Andu ($21.66 in chips) 
Seat 3: TestaDiCazz ($10.39 in chips) 
Seat 4: WI7ZZ ($10.34 in chips) 
Seat 5: AlexDeLargee ($18.74 in chips) 
Seat 6: qqzan ($20.15 in chips) 
Andra.Andu: posts small blind $0.05
TestaDiCazz: posts big blind $0.10
*** HOLE CARDS ***
Dealt to WI7ZZ [3h 8d]
WI7ZZ: folds 
AlexDeLargee: folds 
qqzan: folds 
kamikaza11: folds 
Andra.Andu: folds 
Uncalled bet ($0.05) returned to TestaDiCazz
TestaDiCazz collected $0.10 from pot
TestaDiCazz: doesn't show hand 
*** SUMMARY ***
Total pot $0.10 | Rake $0 
Seat 1: kamikaza11 (button) folded before Flop (didn't bet)
Seat 2: Andra.Andu (small blind) folded before Flop
Seat 3: TestaDiCazz (big blind) collected ($0.10)
Seat 4: WI7ZZ folded before Flop (didn't bet)
Seat 5: AlexDeLargee folded before Flop (didn't bet)
Seat 6: qqzan folded before Flop (didn't bet)



PokerStars Zoom Hand #188749893137:  Hold'em No Limit ($0.05/$0.10) - 2018/07/15 14:26:08 WET [2018/07/15 9:26:08 ET]
Table 'Aludra' 6-max Seat #1 is the button
Seat 1: WI7ZZ ($10.34 in chips) 
Seat 2: Gevron ($39.64 in chips) 
Seat 3: ChungkingExp ($26.74 in chips) 
Seat 4: impulsivo ($11.06 in chips) 
Seat 5: maxniger007 ($3.95 in chips) 
Seat 6: done306 ($10 in chips) 
Gevron: posts small blind $0.05
ChungkingExp: posts big blind $0.10
*** HOLE CARDS ***
Dealt to WI7ZZ [Kd 5d]
impulsivo: raises $0.20 to $0.30
maxniger007: folds 
done306: folds 
WI7ZZ: folds 
Gevron: folds 
ChungkingExp: folds 
Uncalled bet ($0.20) returned to impulsivo
impulsivo collected $0.25 from pot
impulsivo: doesn't show hand 
*** SUMMARY ***
Total pot $0.25 | Rake $0 
Seat 1: WI7ZZ (button) folded before Flop (didn't bet)
Seat 2: Gevron (small blind) folded before Flop
Seat 3: ChungkingExp (big blind) folded before Flop
Seat 4: impulsivo collected ($0.25)
Seat 5: maxniger007 folded before Flop (didn't bet)
Seat 6: done306 folded before Flop (didn't bet)



PokerStars Zoom Hand #188749849670:  Hold'em No Limit ($0.05/$0.10) - 2018/07/15 14:24:44 WET [2018/07/15 9:24:44 ET]
Table 'Aludra' 6-max Seat #1 is the button
Seat 1: actionMoon ($10.10 in chips) 
Seat 2: universe123 ($10.07 in chips) 
Seat 3: Dalibomba ($13.53 in chips) 
Seat 4: WI7ZZ ($10.65 in chips) 
Seat 5: kamikaza11 ($13.28 in chips) 
Seat 6: rvanes ($10.50 in chips) 
universe123: posts small blind $0.05
Dalibomba: posts big blind $0.10
*** HOLE CARDS ***
Dealt to WI7ZZ [8h Qs]
WI7ZZ: folds 
kamikaza11: folds 
rvanes: folds 
actionMoon: raises $0.14 to $0.24
universe123: folds 
Dalibomba: calls $0.14
*** FLOP *** [8c 6h 3s]
Dalibomba: checks 
actionMoon: bets $0.30
Dalibomba: calls $0.30
*** TURN *** [8c 6h 3s] [Js]
Dalibomba: checks 
actionMoon: bets $0.82
Dalibomba: raises $2.04 to $2.86
actionMoon: folds 
Uncalled bet ($2.04) returned to Dalibomba
Dalibomba collected $2.65 from pot
Dalibomba: doesn't show hand 
*** SUMMARY ***
Total pot $2.77 | Rake $0.12 
Board [8c 6h 3s Js]
Seat 1: actionMoon (button) folded on the Turn
Seat 2: universe123 (small blind) folded before Flop
Seat 3: Dalibomba (big blind) collected ($2.65)
Seat 4: WI7ZZ folded before Flop (didn't bet)
Seat 5: kamikaza11 folded before Flop (didn't bet)
Seat 6: rvanes folded before Flop (didn't bet)



PokerStars Zoom Hand #188749898818:  Hold'em No Limit ($0.05/$0.10) - 2018/07/15 14:26:19 WET [2018/07/15 9:26:19 ET]
Table 'Aludra' 6-max Seat #1 is the button
Seat 1: andremgremio ($14.66 in chips) 
Seat 2: WI7ZZ ($10.34 in chips) 
Seat 3: Gradefor ($10 in chips) 
Seat 4: Marsiz ($18.45 in chips) 
Seat 5: shnackattack ($8.06 in chips) 
Seat 6: fillette789 ($9.26 in chips) 
WI7ZZ: posts small blind $0.05
Gradefor: posts big blind $0.10
*** HOLE CARDS ***
Dealt to WI7ZZ [7c Th]
Marsiz: folds 
shnackattack: folds 
fillette789: folds 
andremgremio: raises $0.15 to $0.25
WI7ZZ: folds 
Gradefor: folds 
Uncalled bet ($0.15) returned to andremgremio
andremgremio collected $0.25 from pot
andremgremio: doesn't show hand 
*** SUMMARY ***
Total pot $0.25 | Rake $0 
Seat 1: andremgremio (button) collected ($0.25)
Seat 2: WI7ZZ (small blind) folded before Flop
Seat 3: Gradefor (big blind) folded before Flop
Seat 4: Marsiz folded before Flop (didn't bet)
Seat 5: shnackattack folded before Flop (didn't bet)
Seat 6: fillette789 folded before Flop (didn't bet)



PokerStars Zoom Hand #188749902900:  Hold'em No Limit ($0.05/$0.10) - 2018/07/15 14:26:27 WET [2018/07/15 9:26:27 ET]
Table 'Aludra' 6-max Seat #1 is the button
Seat 1: knullig ($8.02 in chips) 
Seat 2: hamann1188 ($13.44 in chips) 
Seat 3: WI7ZZ ($10.29 in chips) 
Seat 4: impulsivo ($15.01 in chips) 
Seat 5: R0MMMAN ($13.28 in chips) 
Seat 6: Andreas Bich ($17.61 in chips) 
hamann1188: posts small blind $0.05
WI7ZZ: posts big blind $0.10
*** HOLE CARDS ***
Dealt to WI7ZZ [Qs 7s]
impulsivo: folds 
R0MMMAN: folds 
Andreas Bich: folds 
knullig: folds 
hamann1188: folds 
Uncalled bet ($0.05) returned to WI7ZZ
WI7ZZ collected $0.10 from pot
WI7ZZ: doesn't show hand 
*** SUMMARY ***
Total pot $0.10 | Rake $0 
Seat 1: knullig (button) folded before Flop (didn't bet)
Seat 2: hamann1188 (small blind) folded before Flop
Seat 3: WI7ZZ (big blind) collected ($0.10)
Seat 4: impulsivo folded before Flop (didn't bet)
Seat 5: R0MMMAN folded before Flop (didn't bet)
Seat 6: Andreas Bich folded before Flop (didn't bet)



PokerStars Zoom Hand #188749900337:  Hold'em No Limit ($0.05/$0.10) - 2018/07/15 14:26:22 WET [2018/07/15 9:26:22 ET]
Table 'Aludra' 6-max Seat #1 is the button
Seat 1: done306 ($10.33 in chips) 
Seat 2: rest992 ($9.51 in chips) 
Seat 3: R2R2806 ($10.69 in chips) 
Seat 4: Day Day Up6 ($10.90 in chips) 
Seat 5: Dan0505 ($1.30 in chips) 
Seat 6: WI7ZZ ($10.29 in chips) 
rest992: posts small blind $0.05
R2R2806: posts big blind $0.10
*** HOLE CARDS ***
Dealt to WI7ZZ [6h 2d]
Day Day Up6: folds 
Dan0505: folds 
WI7ZZ: folds 
done306: folds 
rest992: folds 
Uncalled bet ($0.05) returned to R2R2806
R2R2806 collected $0.10 from pot
R2R2806: doesn't show hand 
*** SUMMARY ***
Total pot $0.10 | Rake $0 
Seat 1: done306 (button) folded before Flop (didn't bet)
Seat 2: rest992 (small blind) folded before Flop
Seat 3: R2R2806 (big blind) collected ($0.10)
Seat 4: Day Day Up6 folded before Flop (didn't bet)
Seat 5: Dan0505 folded before Flop (didn't bet)
Seat 6: WI7ZZ folded before Flop (didn't bet)



PokerStars Zoom Hand #188749909206:  Hold'em No Limit ($0.05/$0.10) - 2018/07/15 14:26:39 WET [2018/07/15 9:26:39 ET]
Table 'Aludra' 6-max Seat #1 is the button
Seat 1: Fichalicious ($12.06 in chips) 
Seat 2: HebeFans ($12.99 in chips) 
Seat 3: -=l Grek l=- ($11.52 in chips) 
Seat 4: TestaDiCazz ($11.55 in chips) 
Seat 5: WI7ZZ ($10.34 in chips) 
Seat 6: Sunrise1912 ($15.20 in chips) 
HebeFans: posts small blind $0.05
-=l Grek l=-: posts big blind $0.10
*** HOLE CARDS ***
Dealt to WI7ZZ [4h Qd]
TestaDiCazz: folds 
WI7ZZ: folds 
Sunrise1912: folds 
Fichalicious: folds 
HebeFans: folds 
Uncalled bet ($0.05) returned to -=l Grek l=-
-=l Grek l=- collected $0.10 from pot
-=l Grek l=-: doesn't show hand 
*** SUMMARY ***
Total pot $0.10 | Rake $0 
Seat 1: Fichalicious (button) folded before Flop (didn't bet)
Seat 2: HebeFans (small blind) folded before Flop
Seat 3: -=l Grek l=- (big blind) collected ($0.10)
Seat 4: TestaDiCazz folded before Flop (didn't bet)
Seat 5: WI7ZZ folded before Flop (didn't bet)
Seat 6: Sunrise1912 folded before Flop (didn't bet)



PokerStars Zoom Hand #188749907119:  Hold'em No Limit ($0.05/$0.10) - 2018/07/15 14:26:35 WET [2018/07/15 9:26:35 ET]
Table 'Aludra' 6-max Seat #1 is the button
Seat 1: WI7ZZ ($10.34 in chips) 
Seat 2: done306 ($10.33 in chips) 
Seat 3: hellf1re666 ($10.44 in chips) 
Seat 4: Plevi1 ($19.37 in chips) 
Seat 5: cergo18 ($27.16 in chips) 
Seat 6: Gradefor ($11.38 in chips) 
done306: posts small blind $0.05
hellf1re666: posts big blind $0.10
*** HOLE CARDS ***
Dealt to WI7ZZ [3d Jh]
Plevi1: folds 
cergo18: folds 
Gradefor: folds 
WI7ZZ: folds 
done306: raises $0.20 to $0.30
hellf1re666: raises $0.60 to $0.90
done306: folds 
Uncalled bet ($0.60) returned to hellf1re666
hellf1re666 collected $0.60 from pot
hellf1re666: doesn't show hand 
*** SUMMARY ***
Total pot $0.60 | Rake $0 
Seat 1: WI7ZZ (button) folded before Flop (didn't bet)
Seat 2: done306 (small blind) folded before Flop
Seat 3: hellf1re666 (big blind) collected ($0.60)
Seat 4: Plevi1 folded before Flop (didn't bet)
Seat 5: cergo18 folded before Flop (didn't bet)
Seat 6: Gradefor folded before Flop (didn't bet)



PokerStars Zoom Hand #188749917157:  Hold'em No Limit ($0.05/$0.10) - 2018/07/15 14:26:54 WET [2018/07/15 9:26:54 ET]
Table 'Aludra' 6-max Seat #1 is the button
Seat 1: mula200 ($10.54 in chips) 
Seat 2: WI7ZZ ($10.34 in chips) 
Seat 3: Aarons AA ($19.04 in chips) 
Seat 4: paya0809 ($10.15 in chips) 
Seat 5: Foosball1980 ($15.24 in chips) 
Seat 6: pro_raduga ($18.66 in chips) 
WI7ZZ: posts small blind $0.05
Aarons AA: posts big blind $0.10
*** HOLE CARDS ***
Dealt to WI7ZZ [7s 2c]
paya0809: folds 
Foosball1980: folds 
pro_raduga: folds 
mula200: folds 
WI7ZZ: folds 
Uncalled bet ($0.05) returned to Aarons AA
Aarons AA collected $0.10 from pot
Aarons AA: doesn't show hand 
*** SUMMARY ***
Total pot $0.10 | Rake $0 
Seat 1: mula200 (button) folded before Flop (didn't bet)
Seat 2: WI7ZZ (small blind) folded before Flop
Seat 3: Aarons AA (big blind) collected ($0.10)
Seat 4: paya0809 folded before Flop (didn't bet)
Seat 5: Foosball1980 folded before Flop (didn't bet)
Seat 6: pro_raduga folded before Flop (didn't bet)



PokerStars Zoom Hand #188749921784:  Hold'em No Limit ($0.05/$0.10) - 2018/07/15 14:27:03 WET [2018/07/15 9:27:03 ET]
Table 'Aludra' 6-max Seat #1 is the button
Seat 1: Ishimbaec157 ($12.87 in chips) 
Seat 2: FULLFREEDOM ($8.49 in chips) 
Seat 3: WI7ZZ ($10.29 in chips) 
Seat 4: iDecMate ($10 in chips) 
Seat 5: actionMoon ($10.45 in chips) 
Seat 6: CafeDay ($11.11 in chips) 
FULLFREEDOM: posts small blind $0.05
WI7ZZ: posts big blind $0.10
*** HOLE CARDS ***
Dealt to WI7ZZ [3d 6d]
iDecMate: folds 
actionMoon: raises $1.85 to $1.95
CafeDay: folds 
Ishimbaec157: folds 
FULLFREEDOM: folds 
WI7ZZ: folds 
Uncalled bet ($1.85) returned to actionMoon
actionMoon collected $0.25 from pot
actionMoon: doesn't show hand 
*** SUMMARY ***
Total pot $0.25 | Rake $0 
Seat 1: Ishimbaec157 (button) folded before Flop (didn't bet)
Seat 2: FULLFREEDOM (small blind) folded before Flop
Seat 3: WI7ZZ (big blind) folded before Flop
Seat 4: iDecMate folded before Flop (didn't bet)
Seat 5: actionMoon collected ($0.25)
Seat 6: CafeDay folded before Flop (didn't bet)



PokerStars Zoom Hand #188749920256:  Hold'em No Limit ($0.05/$0.10) - 2018/07/15 14:27:00 WET [2018/07/15 9:27:00 ET]
Table 'Aludra' 6-max Seat #1 is the button
Seat 1: RiverLimp 32JS ($7.44 in chips) 
Seat 2: andremgremio ($10 in chips) 
Seat 3: done306 ($10 in chips) 
Seat 4: WI7ZZ ($10.29 in chips) 
Seat 5: Foosball1980 ($13.49 in chips) 
Seat 6: incredibleuh ($17.21 in chips) 
andremgremio: posts small blind $0.05
done306: posts big blind $0.10
*** HOLE CARDS ***
Dealt to WI7ZZ [Ts 5d]
WI7ZZ: folds 
Foosball1980: folds 
incredibleuh: raises $0.20 to $0.30
RiverLimp 32JS: folds 
andremgremio: folds 
done306: calls $0.20
*** FLOP *** [Kh Ad Jd]
done306: checks 
incredibleuh: checks 
*** TURN *** [Kh Ad Jd] [5s]
done306: bets $0.34
incredibleuh: folds 
Uncalled bet ($0.34) returned to done306
done306 collected $0.62 from pot
done306: doesn't show hand 
*** SUMMARY ***
Total pot $0.65 | Rake $0.03 
Board [Kh Ad Jd 5s]
Seat 1: RiverLimp 32JS (button) folded before Flop (didn't bet)
Seat 2: andremgremio (small blind) folded before Flop
Seat 3: done306 (big blind) collected ($0.62)
Seat 4: WI7ZZ folded before Flop (didn't bet)
Seat 5: Foosball1980 folded before Flop (didn't bet)
Seat 6: incredibleuh folded on the Turn



PokerStars Zoom Hand #188749935316:  Hold'em No Limit ($0.05/$0.10) - 2018/07/15 14:27:29 WET [2018/07/15 9:27:29 ET]
Table 'Aludra' 6-max Seat #1 is the button
Seat 1: deRalf67 ($27.80 in chips) 
Seat 2: shu1007 ($21.47 in chips) 
Seat 3: CafeDay ($11.06 in chips) 
Seat 4: WI7ZZ ($10.19 in chips) 
Seat 5: AlexDeLargee ($18.92 in chips) 
Seat 6: Rude8oy9 ($26.59 in chips) 
shu1007: posts small blind $0.05
CafeDay: posts big blind $0.10
*** HOLE CARDS ***
Dealt to WI7ZZ [5d 3d]
WI7ZZ: folds 
AlexDeLargee: folds 
Rude8oy9: folds 
deRalf67: folds 
shu1007: folds 
Uncalled bet ($0.05) returned to CafeDay
CafeDay collected $0.10 from pot
CafeDay: doesn't show hand 
*** SUMMARY ***
Total pot $0.10 | Rake $0 
Seat 1: deRalf67 (button) folded before Flop (didn't bet)
Seat 2: shu1007 (small blind) folded before Flop
Seat 3: CafeDay (big blind) collected ($0.10)
Seat 4: WI7ZZ folded before Flop (didn't bet)
Seat 5: AlexDeLargee folded before Flop (didn't bet)
Seat 6: Rude8oy9 folded before Flop (didn't bet)



PokerStars Zoom Hand #188749911853:  Hold'em No Limit ($0.05/$0.10) - 2018/07/15 14:26:44 WET [2018/07/15 9:26:44 ET]
Table 'Aludra' 6-max Seat #1 is the button
Seat 1: shibachang ($8.09 in chips) 
Seat 2: Vespao20 ($19.04 in chips) 
Seat 3: MalinaN ($13.47 in chips) 
Seat 4: moneyAAces ($9.87 in chips) 
Seat 5: WI7ZZ ($10.34 in chips) 
Seat 6: Gevron ($39.74 in chips) 
Vespao20: posts small blind $0.05
MalinaN: posts big blind $0.10
*** HOLE CARDS ***
Dealt to WI7ZZ [5c 6c]
moneyAAces: raises $0.10 to $0.20
WI7ZZ: folds 
Gevron: folds 
shibachang: folds 
Vespao20: folds 
MalinaN: calls $0.10
*** FLOP *** [4h 7c Jd]
MalinaN: checks 
moneyAAces: checks 
*** TURN *** [4h 7c Jd] [Ts]
MalinaN: bets $0.20
moneyAAces: calls $0.20
*** RIVER *** [4h 7c Jd Ts] [8c]
MalinaN: checks 
moneyAAces: bets $0.60
MalinaN: folds 
Uncalled bet ($0.60) returned to moneyAAces
moneyAAces collected $0.81 from pot
moneyAAces: doesn't show hand 
*** SUMMARY ***
Total pot $0.85 | Rake $0.04 
Board [4h 7c Jd Ts 8c]
Seat 1: shibachang (button) folded before Flop (didn't bet)
Seat 2: Vespao20 (small blind) folded before Flop
Seat 3: MalinaN (big blind) folded on the River
Seat 4: moneyAAces collected ($0.81)
Seat 5: WI7ZZ folded before Flop (didn't bet)
Seat 6: Gevron folded before Flop (didn't bet)



PokerStars Zoom Hand #188749940576:  Hold'em No Limit ($0.05/$0.10) - 2018/07/15 14:27:39 WET [2018/07/15 9:27:39 ET]
Table 'Aludra' 6-max Seat #1 is the button
Seat 1: WI7ZZ ($10.19 in chips) 
Seat 2: DIUK33 ($16.33 in chips) 
Seat 3: qqzan ($28.99 in chips) 
Seat 4: Makiels ($9.80 in chips) 
Seat 5: CojocaruSV ($9.24 in chips) 
Seat 6: shibachang ($8.09 in chips) 
DIUK33: posts small blind $0.05
qqzan: posts big blind $0.10
*** HOLE CARDS ***
Dealt to WI7ZZ [Ad 7s]
Makiels: folds 
CojocaruSV: folds 
shibachang: raises $0.20 to $0.30
WI7ZZ: calls $0.30
DIUK33: folds 
qqzan: folds 
*** FLOP *** [As Jd 8c]
shibachang: checks 
WI7ZZ: bets $0.32
shibachang: folds 
Uncalled bet ($0.32) returned to WI7ZZ
WI7ZZ collected $0.72 from pot
WI7ZZ: doesn't show hand 
*** SUMMARY ***
Total pot $0.75 | Rake $0.03 
Board [As Jd 8c]
Seat 1: WI7ZZ (button) collected ($0.72)
Seat 2: DIUK33 (small blind) folded before Flop
Seat 3: qqzan (big blind) folded before Flop
Seat 4: Makiels folded before Flop (didn't bet)
Seat 5: CojocaruSV folded before Flop (didn't bet)
Seat 6: shibachang folded on the Flop



PokerStars Zoom Hand #188749933770:  Hold'em No Limit ($0.05/$0.10) - 2018/07/15 14:27:26 WET [2018/07/15 9:27:26 ET]
Table 'Aludra' 6-max Seat #1 is the button
Seat 1: Bisull ($10 in chips) 
Seat 2: molis23 ($8.70 in chips) 
Seat 3: CojocaruSV ($9.34 in chips) 
Seat 4: flex609 ($6.17 in chips) 
Seat 5: alfa846 ($12.03 in chips) 
Seat 6: WI7ZZ ($10.19 in chips) 
molis23: posts small blind $0.05
CojocaruSV: posts big blind $0.10
*** HOLE CARDS ***
Dealt to WI7ZZ [9h 2s]
flex609: calls $0.10
alfa846: raises $0.30 to $0.40
WI7ZZ: folds 
Bisull: folds 
molis23: calls $0.35
CojocaruSV: folds 
flex609: calls $0.30
*** FLOP *** [6c 9c Kd]
molis23: checks 
flex609: checks 
alfa846: bets $0.68
molis23: calls $0.68
flex609: calls $0.68
*** TURN *** [6c 9c Kd] [Js]
molis23: checks 
flex609: checks 
alfa846: checks 
*** RIVER *** [6c 9c Kd Js] [5d]
molis23: bets $3.20
flex609: folds 
flex609 is disconnected 
alfa846: folds 
Uncalled bet ($3.20) returned to molis23
molis23 collected $3.19 from pot
molis23: doesn't show hand 
*** SUMMARY ***
Total pot $3.34 | Rake $0.15 
Board [6c 9c Kd Js 5d]
Seat 1: Bisull (button) folded before Flop (didn't bet)
Seat 2: molis23 (small blind) collected ($3.19)
Seat 3: CojocaruSV (big blind) folded before Flop
Seat 4: flex609 folded on the River
Seat 5: alfa846 folded on the River
Seat 6: WI7ZZ folded before Flop (didn't bet)



PokerStars Zoom Hand #188749967413:  Hold'em No Limit ($0.05/$0.10) - 2018/07/15 14:28:30 WET [2018/07/15 9:28:30 ET]
Table 'Aludra' 6-max Seat #1 is the button
Seat 1: alfa846 ($10.95 in chips) 
Seat 2: WI7ZZ ($10.61 in chips) 
Seat 3: xBeesley ($12.90 in chips) 
Seat 4: Sunrise1912 ($16.61 in chips) 
Seat 5: Gradefor ($10 in chips) 
Seat 6: HebeFans ($10 in chips) 
WI7ZZ: posts small blind $0.05
xBeesley: posts big blind $0.10
*** HOLE CARDS ***
Dealt to WI7ZZ [2c Jh]
Sunrise1912: folds 
Gradefor: raises $0.15 to $0.25
HebeFans: folds 
alfa846: folds 
WI7ZZ: folds 
xBeesley: folds 
Uncalled bet ($0.15) returned to Gradefor
Gradefor collected $0.25 from pot
Gradefor: doesn't show hand 
*** SUMMARY ***
Total pot $0.25 | Rake $0 
Seat 1: alfa846 (button) folded before Flop (didn't bet)
Seat 2: WI7ZZ (small blind) folded before Flop
Seat 3: xBeesley (big blind) folded before Flop
Seat 4: Sunrise1912 folded before Flop (didn't bet)
Seat 5: Gradefor collected ($0.25)
Seat 6: HebeFans folded before Flop (didn't bet)



PokerStars Zoom Hand #188749981053:  Hold'em No Limit ($0.05/$0.10) - 2018/07/15 14:28:56 WET [2018/07/15 9:28:56 ET]
Table 'Aludra' 6-max Seat #1 is the button
Seat 1: alfa846 ($11.88 in chips) 
Seat 2: michaltoja ($19.77 in chips) 
Seat 3: ValiumJJ ($10 in chips) 
Seat 4: Radomir 26 ($10 in chips) 
Seat 5: WI7ZZ ($10.46 in chips) 
Seat 6: blasterrrtje ($12.66 in chips) 
michaltoja: posts small blind $0.05
ValiumJJ: posts big blind $0.10
*** HOLE CARDS ***
Dealt to WI7ZZ [Js 5c]
Radomir 26: folds 
WI7ZZ: folds 
blasterrrtje: raises $0.20 to $0.30
alfa846: folds 
michaltoja: folds 
ValiumJJ: folds 
Uncalled bet ($0.20) returned to blasterrrtje
blasterrrtje collected $0.25 from pot
blasterrrtje: doesn't show hand 
*** SUMMARY ***
Total pot $0.25 | Rake $0 
Seat 1: alfa846 (button) folded before Flop (didn't bet)
Seat 2: michaltoja (small blind) folded before Flop
Seat 3: ValiumJJ (big blind) folded before Flop
Seat 4: Radomir 26 folded before Flop (didn't bet)
Seat 5: WI7ZZ folded before Flop (didn't bet)
Seat 6: blasterrrtje collected ($0.25)



PokerStars Zoom Hand #188749972219:  Hold'em No Limit ($0.05/$0.10) - 2018/07/15 14:28:39 WET [2018/07/15 9:28:39 ET]
Table 'Aludra' 6-max Seat #1 is the button
Seat 1: Plevi1 ($8.42 in chips) 
Seat 2: R2R2806 ($11.37 in chips) 
Seat 3: WI7ZZ ($10.56 in chips) 
Seat 4: mikitok ($11.40 in chips) 
Seat 5: yumi2003 ($10.97 in chips) 
Seat 6: kotlecior ($44.92 in chips) 
R2R2806: posts small blind $0.05
WI7ZZ: posts big blind $0.10
*** HOLE CARDS ***
Dealt to WI7ZZ [6h 9s]
mikitok: folds 
yumi2003: folds 
kotlecior: folds 
Plevi1: raises $0.15 to $0.25
R2R2806: calls $0.20
WI7ZZ: folds 
*** FLOP *** [8h Kd Jd]
R2R2806: checks 
Plevi1: bets $0.27
R2R2806: raises $0.63 to $0.90
Plevi1: folds 
Uncalled bet ($0.63) returned to R2R2806
R2R2806 collected $1.09 from pot
R2R2806: doesn't show hand 
*** SUMMARY ***
Total pot $1.14 | Rake $0.05 
Board [8h Kd Jd]
Seat 1: Plevi1 (button) folded on the Flop
Seat 2: R2R2806 (small blind) collected ($1.09)
Seat 3: WI7ZZ (big blind) folded before Flop
Seat 4: mikitok folded before Flop (didn't bet)
Seat 5: yumi2003 folded before Flop (didn't bet)
Seat 6: kotlecior folded before Flop (didn't bet)



PokerStars Zoom Hand #188749982626:  Hold'em No Limit ($0.05/$0.10) - 2018/07/15 14:28:59 WET [2018/07/15 9:28:59 ET]
Table 'Aludra' 6-max Seat #1 is the button
Seat 1: dmmace ($9.80 in chips) 
Seat 2: calin.jahner ($6.40 in chips) 
Seat 3: Cronus2013 ($10.79 in chips) 
Seat 4: HebeFans ($10.51 in chips) 
Seat 5: shnackattack ($3.91 in chips) 
Seat 6: WI7ZZ ($10.46 in chips) 
calin.jahner: posts small blind $0.05
Cronus2013: posts big blind $0.10
*** HOLE CARDS ***
Dealt to WI7ZZ [6d 9c]
HebeFans: folds 
shnackattack: folds 
WI7ZZ: folds 
dmmace: folds 
calin.jahner: calls $0.05
Cronus2013: checks 
*** FLOP *** [9d Qc 7c]
calin.jahner: bets $0.10
Cronus2013: folds 
Uncalled bet ($0.10) returned to calin.jahner
calin.jahner collected $0.19 from pot
calin.jahner: doesn't show hand 
*** SUMMARY ***
Total pot $0.20 | Rake $0.01 
Board [9d Qc 7c]
Seat 1: dmmace (button) folded before Flop (didn't bet)
Seat 2: calin.jahner (small blind) collected ($0.19)
Seat 3: Cronus2013 (big blind) folded on the Flop
Seat 4: HebeFans folded before Flop (didn't bet)
Seat 5: shnackattack folded before Flop (didn't bet)
Seat 6: WI7ZZ folded before Flop (didn't bet)



PokerStars Zoom Hand #188749988416:  Hold'em No Limit ($0.05/$0.10) - 2018/07/15 14:29:10 WET [2018/07/15 9:29:10 ET]
Table 'Aludra' 6-max Seat #1 is the button
Seat 1: WI7ZZ ($10.46 in chips) 
Seat 2: alfa846 ($10.85 in chips) 
Seat 3: moneyAAces ($10.98 in chips) 
Seat 4: shnackattack ($3.91 in chips) 
Seat 5: PollyPeachum ($19.10 in chips) 
Seat 6: Gevron ($19.52 in chips) 
alfa846: posts small blind $0.05
moneyAAces: posts big blind $0.10
*** HOLE CARDS ***
Dealt to WI7ZZ [2c Kd]
shnackattack: folds 
PollyPeachum: folds 
Gevron: folds 
WI7ZZ: folds 
alfa846: raises $0.20 to $0.30
moneyAAces: folds 
Uncalled bet ($0.20) returned to alfa846
alfa846 collected $0.20 from pot
alfa846: doesn't show hand 
*** SUMMARY ***
Total pot $0.20 | Rake $0 
Seat 1: WI7ZZ (button) folded before Flop (didn't bet)
Seat 2: alfa846 (small blind) collected ($0.20)
Seat 3: moneyAAces (big blind) folded before Flop
Seat 4: shnackattack folded before Flop (didn't bet)
Seat 5: PollyPeachum folded before Flop (didn't bet)
Seat 6: Gevron folded before Flop (didn't bet)



PokerStars Zoom Hand #188749997353:  Hold'em No Limit ($0.05/$0.10) - 2018/07/15 14:29:27 WET [2018/07/15 9:29:27 ET]
Table 'Aludra' 6-max Seat #1 is the button
Seat 1: Bisull ($10 in chips) 
Seat 2: colonel_nsk ($13.65 in chips) 
Seat 3: rdleitao ($10.15 in chips) 
Seat 4: WI7ZZ ($10.46 in chips) 
Seat 5: Evgg3 ($11.70 in chips) 
Seat 6: iDecMate ($11.92 in chips) 
colonel_nsk: posts small blind $0.05
rdleitao: posts big blind $0.10
*** HOLE CARDS ***
Dealt to WI7ZZ [9c 4s]
WI7ZZ: folds 
Evgg3: folds 
iDecMate: folds 
Bisull: folds 
colonel_nsk: folds 
Uncalled bet ($0.05) returned to rdleitao
rdleitao collected $0.10 from pot
rdleitao: doesn't show hand 
*** SUMMARY ***
Total pot $0.10 | Rake $0 
Seat 1: Bisull (button) folded before Flop (didn't bet)
Seat 2: colonel_nsk (small blind) folded before Flop
Seat 3: rdleitao (big blind) collected ($0.10)
Seat 4: WI7ZZ folded before Flop (didn't bet)
Seat 5: Evgg3 folded before Flop (didn't bet)
Seat 6: iDecMate folded before Flop (didn't bet)



PokerStars Zoom Hand #188749985291:  Hold'em No Limit ($0.05/$0.10) - 2018/07/15 14:29:04 WET [2018/07/15 9:29:04 ET]
Table 'Aludra' 6-max Seat #1 is the button
Seat 1: LukksAA ($11.04 in chips) 
Seat 2: Radomir 26 ($10 in chips) 
Seat 3: moneyAAces ($10.01 in chips) 
Seat 4: maktuiu ($9.08 in chips) 
Seat 5: WI7ZZ ($10.46 in chips) 
Seat 6: ysha76 ($12.96 in chips) 
Radomir 26: posts small blind $0.05
moneyAAces: posts big blind $0.10
*** HOLE CARDS ***
Dealt to WI7ZZ [2d Kd]
maktuiu: folds 
WI7ZZ: folds 
ysha76: raises $0.20 to $0.30
LukksAA: raises $0.60 to $0.90
Radomir 26: folds 
moneyAAces: folds 
ysha76: calls $0.60
*** FLOP *** [Kc 5s Ad]
ysha76: checks 
LukksAA: checks 
*** TURN *** [Kc 5s Ad] [6s]
ysha76: checks 
LukksAA: checks 
*** RIVER *** [Kc 5s Ad 6s] [Qs]
ysha76: checks 
LukksAA: checks 
*** SHOW DOWN ***
ysha76: shows [7h 7s] (a pair of Sevens)
LukksAA: shows [Jh Js] (a pair of Jacks)
LukksAA collected $1.86 from pot
*** SUMMARY ***
Total pot $1.95 | Rake $0.09 
Board [Kc 5s Ad 6s Qs]
Seat 1: LukksAA (button) showed [Jh Js] and won ($1.86) with a pair of Jacks
Seat 2: Radomir 26 (small blind) folded before Flop
Seat 3: moneyAAces (big blind) folded before Flop
Seat 4: maktuiu folded before Flop (didn't bet)
Seat 5: WI7ZZ folded before Flop (didn't bet)
Seat 6: ysha76 showed [7h 7s] and lost with a pair of Sevens



PokerStars Zoom Hand #188750000041:  Hold'em No Limit ($0.05/$0.10) - 2018/07/15 14:29:32 WET [2018/07/15 9:29:32 ET]
Table 'Aludra' 6-max Seat #1 is the button
Seat 1: impulsivo ($12.54 in chips) 
Seat 2: WI7ZZ ($10.46 in chips) 
Seat 3: atigokus ($8.79 in chips) 
Seat 4: Spooks1337 ($35.30 in chips) 
Seat 5: Fichalicious ($11.99 in chips) 
Seat 6: knullig ($6.62 in chips) 
WI7ZZ: posts small blind $0.05
atigokus: posts big blind $0.10
*** HOLE CARDS ***
Dealt to WI7ZZ [Ac 4h]
Spooks1337: raises $0.20 to $0.30
Fichalicious: calls $0.30
knullig: folds 
impulsivo: folds 
WI7ZZ: calls $0.25
atigokus: calls $0.20
*** FLOP *** [Js Qd Kc]
WI7ZZ: checks 
atigokus: checks 
Spooks1337: checks 
Fichalicious: checks 
*** TURN *** [Js Qd Kc] [Th]
WI7ZZ: bets $0.71
atigokus: folds 
Spooks1337: folds 
Fichalicious: calls $0.71
*** RIVER *** [Js Qd Kc Th] [6d]
WI7ZZ: bets $1.10
Fichalicious: calls $1.10
*** SHOW DOWN ***
WI7ZZ: shows [Ac 4h] (a straight, Ten to Ace)
Fichalicious: shows [3h Ah] (a straight, Ten to Ace)
WI7ZZ collected $2.30 from pot
Fichalicious collected $2.30 from pot
*** SUMMARY ***
Total pot $4.82 | Rake $0.22 
Board [Js Qd Kc Th 6d]
Seat 1: impulsivo (button) folded before Flop (didn't bet)
Seat 2: WI7ZZ (small blind) showed [Ac 4h] and won ($2.30) with a straight, Ten to Ace
Seat 3: atigokus (big blind) folded on the Turn
Seat 4: Spooks1337 folded on the Turn
Seat 5: Fichalicious showed [3h Ah] and won ($2.30) with a straight, Ten to Ace
Seat 6: knullig folded before Flop (didn't bet)



PokerStars Zoom Hand #188770020761:  Hold'em No Limit ($0.05/$0.10) - 2018/07/15 23:16:49 WET [2018/07/15 18:16:49 ET]
Table 'Aludra' 6-max Seat #1 is the button
Seat 1: LtGrimms ($10.15 in chips) 
Seat 2: xabaza ($10.29 in chips) 
Seat 3: WI7ZZ ($10 in chips) 
Seat 4: lihkel ($10.84 in chips) 
Seat 5: Bisull ($28.61 in chips) 
Seat 6: MijatM ($14.89 in chips) 
xabaza: posts small blind $0.05
WI7ZZ: posts big blind $0.10
*** HOLE CARDS ***
Dealt to WI7ZZ [9s 7c]
lihkel: folds 
Bisull: folds 
MijatM: folds 
LtGrimms: raises $0.25 to $0.35
xabaza: raises $0.85 to $1.20
WI7ZZ: folds 
LtGrimms: folds 
Uncalled bet ($0.85) returned to xabaza
xabaza collected $0.80 from pot
xabaza: doesn't show hand 
*** SUMMARY ***
Total pot $0.80 | Rake $0 
Seat 1: LtGrimms (button) folded before Flop
Seat 2: xabaza (small blind) collected ($0.80)
Seat 3: WI7ZZ (big blind) folded before Flop
Seat 4: lihkel folded before Flop (didn't bet)
Seat 5: Bisull folded before Flop (didn't bet)
Seat 6: MijatM folded before Flop (didn't bet)



PokerStars Zoom Hand #188770031023:  Hold'em No Limit ($0.05/$0.10) - 2018/07/15 23:17:05 WET [2018/07/15 18:17:05 ET]
Table 'Aludra' 6-max Seat #1 is the button
Seat 1: *GAIM*OVER*007* ($13.77 in chips) 
Seat 2: WI7ZZ ($9.90 in chips) 
Seat 3: sestol ($11.35 in chips) 
Seat 4: Viiiru ($10.34 in chips) 
Seat 5: Angerona4 ($2.31 in chips) 
Seat 6: Dmitriy316i ($28.81 in chips) 
WI7ZZ: posts small blind $0.05
sestol: posts big blind $0.10
*** HOLE CARDS ***
Dealt to WI7ZZ [Ts 9h]
Viiiru: folds 
Angerona4: folds 
Dmitriy316i: folds 
*GAIM*OVER*007*: folds 
WI7ZZ: folds 
Uncalled bet ($0.05) returned to sestol
sestol collected $0.10 from pot
sestol: doesn't show hand 
*** SUMMARY ***
Total pot $0.10 | Rake $0 
Seat 1: *GAIM*OVER*007* (button) folded before Flop (didn't bet)
Seat 2: WI7ZZ (small blind) folded before Flop
Seat 3: sestol (big blind) collected ($0.10)
Seat 4: Viiiru folded before Flop (didn't bet)
Seat 5: Angerona4 folded before Flop (didn't bet)
Seat 6: Dmitriy316i folded before Flop (didn't bet)



PokerStars Zoom Hand #188770032947:  Hold'em No Limit ($0.05/$0.10) - 2018/07/15 23:17:08 WET [2018/07/15 18:17:08 ET]
Table 'Aludra' 6-max Seat #1 is the button
Seat 1: DoubleBlue39 ($8.46 in chips) 
Seat 2: Dimka441 ($9.90 in chips) 
Seat 3: metadonk ($10 in chips) 
Seat 4: John Bon Galt ($37.90 in chips) 
Seat 5: coltzu03 ($12.84 in chips) 
Seat 6: WI7ZZ ($9.85 in chips) 
Dimka441: posts small blind $0.05
metadonk: posts big blind $0.10
*** HOLE CARDS ***
Dealt to WI7ZZ [9s 5c]
John Bon Galt: raises $0.15 to $0.25
coltzu03: folds 
WI7ZZ: folds 
DoubleBlue39: folds 
Dimka441: folds 
metadonk: folds 
Uncalled bet ($0.15) returned to John Bon Galt
John Bon Galt collected $0.25 from pot
John Bon Galt: doesn't show hand 
*** SUMMARY ***
Total pot $0.25 | Rake $0 
Seat 1: DoubleBlue39 (button) folded before Flop (didn't bet)
Seat 2: Dimka441 (small blind) folded before Flop
Seat 3: metadonk (big blind) folded before Flop
Seat 4: John Bon Galt collected ($0.25)
Seat 5: coltzu03 folded before Flop (didn't bet)
Seat 6: WI7ZZ folded before Flop (didn't bet)



PokerStars Zoom Hand #188770038683:  Hold'em No Limit ($0.05/$0.10) - 2018/07/15 23:17:17 WET [2018/07/15 18:17:17 ET]
Table 'Aludra' 6-max Seat #1 is the button
Seat 1: WI7ZZ ($9.85 in chips) 
Seat 2: malkata_pz ($48.50 in chips) 
Seat 3: madi1206 ($7.78 in chips) 
Seat 4: Florea2312 ($12.90 in chips) 
Seat 5: DanPlucky ($21.71 in chips) 
Seat 6: hellf1re666 ($10.05 in chips) 
malkata_pz: posts small blind $0.05
madi1206: posts big blind $0.10
*** HOLE CARDS ***
Dealt to WI7ZZ [7d Ks]
Florea2312: folds 
DanPlucky: calls $0.10
hellf1re666: raises $0.27 to $0.37
WI7ZZ: folds 
malkata_pz: folds 
madi1206: folds 
DanPlucky: calls $0.27
*** FLOP *** [Js 7h 2d]
DanPlucky: checks 
hellf1re666: bets $0.66
DanPlucky: folds 
Uncalled bet ($0.66) returned to hellf1re666
hellf1re666 collected $0.85 from pot
hellf1re666: doesn't show hand 
*** SUMMARY ***
Total pot $0.89 | Rake $0.04 
Board [Js 7h 2d]
Seat 1: WI7ZZ (button) folded before Flop (didn't bet)
Seat 2: malkata_pz (small blind) folded before Flop
Seat 3: madi1206 (big blind) folded before Flop
Seat 4: Florea2312 folded before Flop (didn't bet)
Seat 5: DanPlucky folded on the Flop
Seat 6: hellf1re666 collected ($0.85)



PokerStars Zoom Hand #188770070288:  Hold'em No Limit ($0.05/$0.10) - 2018/07/15 23:18:06 WET [2018/07/15 18:18:06 ET]
Table 'Aludra' 6-max Seat #1 is the button
Seat 1: ntr2xit ($6.38 in chips) 
Seat 2: OMG itz Sams ($10 in chips) 
Seat 3: jdimindtrix ($15.59 in chips) 
Seat 4: Synelnikoff ($16.25 in chips) 
Seat 5: WI7ZZ ($9.75 in chips) 
Seat 6: kilechka ($8.93 in chips) 
OMG itz Sams: posts small blind $0.05
jdimindtrix: posts big blind $0.10
*** HOLE CARDS ***
Dealt to WI7ZZ [Kc 2d]
Synelnikoff: folds 
WI7ZZ: folds 
kilechka: folds 
ntr2xit: raises $0.15 to $0.25
OMG itz Sams: folds 
jdimindtrix: folds 
Uncalled bet ($0.15) returned to ntr2xit
ntr2xit collected $0.25 from pot
ntr2xit: doesn't show hand 
*** SUMMARY ***
Total pot $0.25 | Rake $0 
Seat 1: ntr2xit (button) collected ($0.25)
Seat 2: OMG itz Sams (small blind) folded before Flop
Seat 3: jdimindtrix (big blind) folded before Flop
Seat 4: Synelnikoff folded before Flop (didn't bet)
Seat 5: WI7ZZ folded before Flop (didn't bet)
Seat 6: kilechka folded before Flop (didn't bet)



PokerStars Zoom Hand #188770077326:  Hold'em No Limit ($0.05/$0.10) - 2018/07/15 23:18:17 WET [2018/07/15 18:18:17 ET]
Table 'Aludra' 6-max Seat #1 is the button
Seat 1: Carcotasul81 ($10.04 in chips) 
Seat 2: WI7ZZ ($9.75 in chips) 
Seat 3: PokerFlashSG ($7.29 in chips) 
Seat 4: metadonk ($10 in chips) 
Seat 5: NDA_VIE ($20.92 in chips) 
Seat 6: xex_serg ($29.98 in chips) 
WI7ZZ: posts small blind $0.05
PokerFlashSG: posts big blind $0.10
*** HOLE CARDS ***
Dealt to WI7ZZ [2h 3h]
metadonk: raises $0.17 to $0.27
NDA_VIE: folds 
xex_serg: folds 
Carcotasul81: calls $0.27
WI7ZZ: folds 
PokerFlashSG: folds 
*** FLOP *** [Qs Jd 9h]
metadonk: checks 
Carcotasul81: bets $0.20
metadonk: folds 
Uncalled bet ($0.20) returned to Carcotasul81
Carcotasul81 collected $0.66 from pot
Carcotasul81: doesn't show hand 
*** SUMMARY ***
Total pot $0.69 | Rake $0.03 
Board [Qs Jd 9h]
Seat 1: Carcotasul81 (button) collected ($0.66)
Seat 2: WI7ZZ (small blind) folded before Flop
Seat 3: PokerFlashSG (big blind) folded before Flop
Seat 4: metadonk folded on the Flop
Seat 5: NDA_VIE folded before Flop (didn't bet)
Seat 6: xex_serg folded before Flop (didn't bet)



PokerStars Zoom Hand #188770051536:  Hold'em No Limit ($0.05/$0.10) - 2018/07/15 23:17:37 WET [2018/07/15 18:17:37 ET]
Table 'Aludra' 6-max Seat #1 is the button
Seat 1: Pinkisu ($21.61 in chips) 
Seat 2: peoplesfront ($10.28 in chips) 
Seat 3: SuDDen1991 ($17.75 in chips) 
Seat 4: monoalive ($7.31 in chips) 
Seat 5: WI7ZZ ($9.85 in chips) 
Seat 6: o5car05 ($15.66 in chips) 
peoplesfront: posts small blind $0.05
SuDDen1991: posts big blind $0.10
*** HOLE CARDS ***
Dealt to WI7ZZ [7h 8d]
monoalive: folds 
WI7ZZ: folds 
o5car05: raises $0.20 to $0.30
Pinkisu: folds 
peoplesfront: folds 
SuDDen1991: calls $0.20
*** FLOP *** [6s 2s As]
SuDDen1991: checks 
o5car05: bets $0.41
SuDDen1991: raises $1.08 to $1.49
o5car05: calls $1.08
*** TURN *** [6s 2s As] [Js]
SuDDen1991: checks 
o5car05: checks 
*** RIVER *** [6s 2s As Js] [5h]
SuDDen1991: bets $2.31
o5car05: folds 
Uncalled bet ($2.31) returned to SuDDen1991
SuDDen1991 collected $3.47 from pot
SuDDen1991: doesn't show hand 
*** SUMMARY ***
Total pot $3.63 | Rake $0.16 
Board [6s 2s As Js 5h]
Seat 1: Pinkisu (button) folded before Flop (didn't bet)
Seat 2: peoplesfront (small blind) folded before Flop
Seat 3: SuDDen1991 (big blind) collected ($3.47)
Seat 4: monoalive folded before Flop (didn't bet)
Seat 5: WI7ZZ folded before Flop (didn't bet)
Seat 6: o5car05 folded on the River



PokerStars Zoom Hand #188770086356:  Hold'em No Limit ($0.05/$0.10) - 2018/07/15 23:18:31 WET [2018/07/15 18:18:31 ET]
Table 'Aludra' 6-max Seat #1 is the button
Seat 1: FacE_DowN_42 ($69.65 in chips) 
Seat 2: Pardaroxon ($10 in chips) 
Seat 3: AgVolder ($25.20 in chips) 
Seat 4: metadonk ($12.67 in chips) 
Seat 5: AceMutley ($13.41 in chips) 
Seat 6: WI7ZZ ($9.70 in chips) 
Pardaroxon: posts small blind $0.05
AgVolder: posts big blind $0.10
*** HOLE CARDS ***
Dealt to WI7ZZ [Ah Kh]
metadonk: folds 
AceMutley: folds 
WI7ZZ: raises $0.26 to $0.36
FacE_DowN_42: folds 
Pardaroxon: folds 
AgVolder: folds 
Uncalled bet ($0.26) returned to WI7ZZ
WI7ZZ collected $0.25 from pot
WI7ZZ: doesn't show hand 
*** SUMMARY ***
Total pot $0.25 | Rake $0 
Seat 1: FacE_DowN_42 (button) folded before Flop (didn't bet)
Seat 2: Pardaroxon (small blind) folded before Flop
Seat 3: AgVolder (big blind) folded before Flop
Seat 4: metadonk folded before Flop (didn't bet)
Seat 5: AceMutley folded before Flop (didn't bet)
Seat 6: WI7ZZ collected ($0.25)



PokerStars Zoom Hand #188770059930:  Hold'em No Limit ($0.05/$0.10) - 2018/07/15 23:17:50 WET [2018/07/15 18:17:50 ET]
Table 'Aludra' 6-max Seat #1 is the button
Seat 1: redsy22 ($20.47 in chips) 
Seat 2: tmWudzy ($10 in chips) 
Seat 3: WI7ZZ ($9.85 in chips) 
Seat 4: mentaltony ($12.86 in chips) 
Seat 5: LtGrimms ($10.09 in chips) 
Seat 6: Campbeller ($25.27 in chips) 
tmWudzy: posts small blind $0.05
WI7ZZ: posts big blind $0.10
*** HOLE CARDS ***
Dealt to WI7ZZ [4d Qc]
mentaltony: folds 
LtGrimms: raises $0.15 to $0.25
Campbeller has timed out
Campbeller: folds 
redsy22: folds 
tmWudzy: raises $0.65 to $0.90
WI7ZZ: folds 
LtGrimms: calls $0.65
*** FLOP *** [8d 6s 2d]
tmWudzy: checks 
LtGrimms: checks 
*** TURN *** [8d 6s 2d] [7h]
tmWudzy: bets $1.20
LtGrimms: folds 
Uncalled bet ($1.20) returned to tmWudzy
tmWudzy collected $1.81 from pot
tmWudzy: doesn't show hand 
*** SUMMARY ***
Total pot $1.90 | Rake $0.09 
Board [8d 6s 2d 7h]
Seat 1: redsy22 (button) folded before Flop (didn't bet)
Seat 2: tmWudzy (small blind) collected ($1.81)
Seat 3: WI7ZZ (big blind) folded before Flop
Seat 4: mentaltony folded before Flop (didn't bet)
Seat 5: LtGrimms folded on the Turn
Seat 6: Campbeller folded before Flop (didn't bet)



PokerStars Zoom Hand #188770096088:  Hold'em No Limit ($0.05/$0.10) - 2018/07/15 23:18:46 WET [2018/07/15 18:18:46 ET]
Table 'Aludra' 6-max Seat #1 is the button
Seat 1: MelOMel61 ($15.43 in chips) 
Seat 2: space888ht ($11 in chips) 
Seat 3: kaspars n ($10.82 in chips) 
Seat 4: WI7ZZ ($9.85 in chips) 
Seat 5: mynamefds ($16.08 in chips) 
Seat 6: MiddleLittle ($10.23 in chips) 
space888ht: posts small blind $0.05
kaspars n: posts big blind $0.10
*** HOLE CARDS ***
Dealt to WI7ZZ [4d Td]
WI7ZZ: folds 
mynamefds: folds 
MiddleLittle: folds 
MelOMel61: folds 
space888ht: folds 
Uncalled bet ($0.05) returned to kaspars n
kaspars n collected $0.10 from pot
kaspars n: doesn't show hand 
*** SUMMARY ***
Total pot $0.10 | Rake $0 
Seat 1: MelOMel61 (button) folded before Flop (didn't bet)
Seat 2: space888ht (small blind) folded before Flop
Seat 3: kaspars n (big blind) collected ($0.10)
Seat 4: WI7ZZ folded before Flop (didn't bet)
Seat 5: mynamefds folded before Flop (didn't bet)
Seat 6: MiddleLittle folded before Flop (didn't bet)



PokerStars Zoom Hand #188770101742:  Hold'em No Limit ($0.05/$0.10) - 2018/07/15 23:18:55 WET [2018/07/15 18:18:55 ET]
Table 'Aludra' 6-max Seat #1 is the button
Seat 1: WI7ZZ ($9.85 in chips) 
Seat 2: impulsivo ($18.10 in chips) 
Seat 3: Nikel31 ($10 in chips) 
Seat 4: KOUKOU296 ($33.30 in chips) 
Seat 5: Lunettesman ($12.79 in chips) 
Seat 6: hellf1re666 ($10.53 in chips) 
impulsivo: posts small blind $0.05
Nikel31: posts big blind $0.10
*** HOLE CARDS ***
Dealt to WI7ZZ [4c Kh]
KOUKOU296: folds 
Lunettesman: folds 
hellf1re666: folds 
WI7ZZ: folds 
impulsivo: folds 
Uncalled bet ($0.05) returned to Nikel31
Nikel31 collected $0.10 from pot
Nikel31: doesn't show hand 
*** SUMMARY ***
Total pot $0.10 | Rake $0 
Seat 1: WI7ZZ (button) folded before Flop (didn't bet)
Seat 2: impulsivo (small blind) folded before Flop
Seat 3: Nikel31 (big blind) collected ($0.10)
Seat 4: KOUKOU296 folded before Flop (didn't bet)
Seat 5: Lunettesman folded before Flop (didn't bet)
Seat 6: hellf1re666 folded before Flop (didn't bet)



PokerStars Zoom Hand #188770104275:  Hold'em No Limit ($0.05/$0.10) - 2018/07/15 23:18:59 WET [2018/07/15 18:18:59 ET]
Table 'Aludra' 6-max Seat #1 is the button
Seat 1: mynamefds ($10 in chips) 
Seat 2: WI7ZZ ($9.85 in chips) 
Seat 3: dzoint ($10.15 in chips) 
Seat 4: Ketsudan ($15.86 in chips) 
Seat 5: mentaltony ($12.39 in chips) 
Seat 6: Duba709 ($9.35 in chips) 
WI7ZZ: posts small blind $0.05
dzoint: posts big blind $0.10
*** HOLE CARDS ***
Dealt to WI7ZZ [Tc Qs]
Ketsudan: folds 
mentaltony: folds 
Duba709: folds 
mynamefds: folds 
WI7ZZ: raises $0.16 to $0.26
dzoint: calls $0.16
*** FLOP *** [3d 8d 4h]
WI7ZZ: checks 
dzoint: checks 
*** TURN *** [3d 8d 4h] [Th]
WI7ZZ: bets $0.22
dzoint: folds 
Uncalled bet ($0.22) returned to WI7ZZ
WI7ZZ collected $0.50 from pot
WI7ZZ: doesn't show hand 
*** SUMMARY ***
Total pot $0.52 | Rake $0.02 
Board [3d 8d 4h Th]
Seat 1: mynamefds (button) folded before Flop (didn't bet)
Seat 2: WI7ZZ (small blind) collected ($0.50)
Seat 3: dzoint (big blind) folded on the Turn
Seat 4: Ketsudan folded before Flop (didn't bet)
Seat 5: mentaltony folded before Flop (didn't bet)
Seat 6: Duba709 folded before Flop (didn't bet)



PokerStars Zoom Hand #188770126869:  Hold'em No Limit ($0.05/$0.10) - 2018/07/15 23:19:34 WET [2018/07/15 18:19:34 ET]
Table 'Aludra' 6-max Seat #1 is the button
Seat 1: POkerSlanina ($12.55 in chips) 
Seat 2: xabaza ($16.32 in chips) 
Seat 3: WI7ZZ ($10.09 in chips) 
Seat 4: aydarik0890 ($1.53 in chips) 
Seat 5: Only_Vizard ($13.86 in chips) 
Seat 6: pstar11 ($11.27 in chips) 
xabaza: posts small blind $0.05
WI7ZZ: posts big blind $0.10
*** HOLE CARDS ***
Dealt to WI7ZZ [Jd Qc]
aydarik0890: folds 
Only_Vizard: folds 
pstar11: raises $0.20 to $0.30
POkerSlanina: calls $0.30
xabaza: folds 
WI7ZZ: calls $0.20
*** FLOP *** [7s Ts Kh]
WI7ZZ: checks 
pstar11: bets $0.50
POkerSlanina: folds 
WI7ZZ: calls $0.50
*** TURN *** [7s Ts Kh] [2s]
WI7ZZ: bets $1.15
pstar11: folds 
Uncalled bet ($1.15) returned to WI7ZZ
WI7ZZ collected $1.86 from pot
WI7ZZ: doesn't show hand 
*** SUMMARY ***
Total pot $1.95 | Rake $0.09 
Board [7s Ts Kh 2s]
Seat 1: POkerSlanina (button) folded on the Flop
Seat 2: xabaza (small blind) folded before Flop
Seat 3: WI7ZZ (big blind) collected ($1.86)
Seat 4: aydarik0890 folded before Flop (didn't bet)
Seat 5: Only_Vizard folded before Flop (didn't bet)
Seat 6: pstar11 folded on the Turn



PokerStars Zoom Hand #188770160074:  Hold'em No Limit ($0.05/$0.10) - 2018/07/15 23:20:26 WET [2018/07/15 18:20:26 ET]
Table 'Aludra' 6-max Seat #1 is the button
Seat 1: WI7ZZ ($11.15 in chips) 
Seat 2: teoter ($12.52 in chips) 
Seat 3: Liandrine ($45.24 in chips) 
Seat 4: KOUKOU296 ($33.20 in chips) 
Seat 5: anacleto1973 ($20.85 in chips) 
Seat 6: DZHUSSOEV ($13.51 in chips) 
teoter: posts small blind $0.05
Liandrine: posts big blind $0.10
*** HOLE CARDS ***
Dealt to WI7ZZ [3c Jd]
KOUKOU296: raises $0.20 to $0.30
anacleto1973: folds 
DZHUSSOEV: folds 
WI7ZZ: folds 
teoter: folds 
Liandrine: calls $0.20
*** FLOP *** [2d Qs 4c]
Liandrine: checks 
KOUKOU296: bets $0.30
Liandrine: folds 
Uncalled bet ($0.30) returned to KOUKOU296
KOUKOU296 collected $0.62 from pot
KOUKOU296: doesn't show hand 
*** SUMMARY ***
Total pot $0.65 | Rake $0.03 
Board [2d Qs 4c]
Seat 1: WI7ZZ (button) folded before Flop (didn't bet)
Seat 2: teoter (small blind) folded before Flop
Seat 3: Liandrine (big blind) folded on the Flop
Seat 4: KOUKOU296 collected ($0.62)
Seat 5: anacleto1973 folded before Flop (didn't bet)
Seat 6: DZHUSSOEV folded before Flop (didn't bet)



PokerStars Zoom Hand #188770165198:  Hold'em No Limit ($0.05/$0.10) - 2018/07/15 23:20:34 WET [2018/07/15 18:20:34 ET]
Table 'Aludra' 6-max Seat #1 is the button
Seat 1: WI7ZZ ($11.15 in chips) 
Seat 2: MijatM ($21.81 in chips) 
Seat 3: fraudster405 ($24.80 in chips) 
Seat 4: $orokoput ($29.05 in chips) 
Seat 5: WaiT4U ($10 in chips) 
Seat 6: Cheskyud ($5.49 in chips) 
MijatM: posts small blind $0.05
fraudster405: posts big blind $0.10
*** HOLE CARDS ***
Dealt to WI7ZZ [Ts 9d]
$orokoput: folds 
WaiT4U: folds 
Cheskyud: raises $0.10 to $0.20
WI7ZZ: folds 
MijatM: folds 
fraudster405: folds 
Uncalled bet ($0.10) returned to Cheskyud
Cheskyud collected $0.25 from pot
Cheskyud: doesn't show hand 
*** SUMMARY ***
Total pot $0.25 | Rake $0 
Seat 1: WI7ZZ (button) folded before Flop (didn't bet)
Seat 2: MijatM (small blind) folded before Flop
Seat 3: fraudster405 (big blind) folded before Flop
Seat 4: $orokoput folded before Flop (didn't bet)
Seat 5: WaiT4U folded before Flop (didn't bet)
Seat 6: Cheskyud collected ($0.25)



PokerStars Zoom Hand #188770163270:  Hold'em No Limit ($0.05/$0.10) - 2018/07/15 23:20:31 WET [2018/07/15 18:20:31 ET]
Table 'Aludra' 6-max Seat #1 is the button
Seat 1: pandacinho ($38.33 in chips) 
Seat 2: OopSsat ($24.71 in chips) 
Seat 3: PauleP ($8.42 in chips) 
Seat 4: WI7ZZ ($11.15 in chips) 
Seat 5: Dokerokk23 ($13.88 in chips) 
Seat 6: Ignatenkov ($15.19 in chips) 
OopSsat: posts small blind $0.05
PauleP: posts big blind $0.10
*** HOLE CARDS ***
Dealt to WI7ZZ [6d 3d]
WI7ZZ: folds 
Dokerokk23: folds 
Ignatenkov: folds 
pandacinho: folds 
OopSsat: raises $0.20 to $0.30
PauleP: folds 
Uncalled bet ($0.20) returned to OopSsat
OopSsat collected $0.20 from pot
OopSsat: doesn't show hand 
*** SUMMARY ***
Total pot $0.20 | Rake $0 
Seat 1: pandacinho (button) folded before Flop (didn't bet)
Seat 2: OopSsat (small blind) collected ($0.20)
Seat 3: PauleP (big blind) folded before Flop
Seat 4: WI7ZZ folded before Flop (didn't bet)
Seat 5: Dokerokk23 folded before Flop (didn't bet)
Seat 6: Ignatenkov folded before Flop (didn't bet)



PokerStars Zoom Hand #188770158772:  Hold'em No Limit ($0.05/$0.10) - 2018/07/15 23:20:24 WET [2018/07/15 18:20:24 ET]
Table 'Aludra' 6-max Seat #1 is the button
Seat 1: mynamefds ($11.02 in chips) 
Seat 2: xex_serg ($10.02 in chips) 
Seat 3: ThiagooPaiva ($11.59 in chips) 
Seat 4: mentaltony ($10 in chips) 
Seat 5: steevesy15 ($3.82 in chips) 
Seat 6: WI7ZZ ($11.15 in chips) 
xex_serg: posts small blind $0.05
ThiagooPaiva: posts big blind $0.10
*** HOLE CARDS ***
Dealt to WI7ZZ [7d 4c]
mentaltony: folds 
steevesy15: folds 
WI7ZZ: folds 
mynamefds: folds 
xex_serg: raises $0.17 to $0.27
ThiagooPaiva: calls $0.17
*** FLOP *** [Kd 3s Ah]
xex_serg: checks 
ThiagooPaiva: bets $0.35
xex_serg: folds 
Uncalled bet ($0.35) returned to ThiagooPaiva
ThiagooPaiva collected $0.52 from pot
ThiagooPaiva: doesn't show hand 
*** SUMMARY ***
Total pot $0.54 | Rake $0.02 
Board [Kd 3s Ah]
Seat 1: mynamefds (button) folded before Flop (didn't bet)
Seat 2: xex_serg (small blind) folded on the Flop
Seat 3: ThiagooPaiva (big blind) collected ($0.52)
Seat 4: mentaltony folded before Flop (didn't bet)
Seat 5: steevesy15 folded before Flop (didn't bet)
Seat 6: WI7ZZ folded before Flop (didn't bet)



PokerStars Zoom Hand #188770161975:  Hold'em No Limit ($0.05/$0.10) - 2018/07/15 23:20:29 WET [2018/07/15 18:20:29 ET]
Table 'Aludra' 6-max Seat #1 is the button
Seat 1: JO9JO243 ($10.04 in chips) 
Seat 2: Carcotasul81 ($9.13 in chips) 
Seat 3: mentaltony ($10 in chips) 
Seat 4: xabaza ($8.68 in chips) 
Seat 5: WI7ZZ ($11.15 in chips) 
Seat 6: Sea Bas123 ($11.99 in chips) 
Carcotasul81: posts small blind $0.05
mentaltony: posts big blind $0.10
*** HOLE CARDS ***
Dealt to WI7ZZ [2h 4s]
xabaza: folds 
WI7ZZ: folds 
Sea Bas123: folds 
JO9JO243: raises $0.25 to $0.35
Carcotasul81: calls $0.30
mentaltony: raises $1.15 to $1.50
JO9JO243: folds 
Carcotasul81: calls $1.15
*** FLOP *** [Ad 9s 7h]
Carcotasul81: checks 
mentaltony: bets $1.28
Carcotasul81: folds 
Uncalled bet ($1.28) returned to mentaltony
mentaltony collected $3.20 from pot
mentaltony: doesn't show hand 
*** SUMMARY ***
Total pot $3.35 | Rake $0.15 
Board [Ad 9s 7h]
Seat 1: JO9JO243 (button) folded before Flop
Seat 2: Carcotasul81 (small blind) folded on the Flop
Seat 3: mentaltony (big blind) collected ($3.20)
Seat 4: xabaza folded before Flop (didn't bet)
Seat 5: WI7ZZ folded before Flop (didn't bet)
Seat 6: Sea Bas123 folded before Flop (didn't bet)



PokerStars Zoom Hand #188770166465:  Hold'em No Limit ($0.05/$0.10) - 2018/07/15 23:20:36 WET [2018/07/15 18:20:36 ET]
Table 'Aludra' 6-max Seat #1 is the button
Seat 1: Campbeller ($22.94 in chips) 
Seat 2: v4mp1req ($15.64 in chips) 
Seat 3: WI7ZZ ($11.15 in chips) 
Seat 4: ralf113 ($12.09 in chips) 
Seat 5: naueru ($16.68 in chips) 
Seat 6: OopSsat ($10.53 in chips) 
v4mp1req: posts small blind $0.05
WI7ZZ: posts big blind $0.10
*** HOLE CARDS ***
Dealt to WI7ZZ [6c Qh]
ralf113: folds 
naueru: folds 
OopSsat: folds 
Campbeller has timed out while disconnected
Campbeller: folds 
v4mp1req: calls $0.05
WI7ZZ: checks 
*** FLOP *** [8s 5d 9c]
v4mp1req: checks 
WI7ZZ: checks 
*** TURN *** [8s 5d 9c] [Kh]
v4mp1req: checks 
WI7ZZ: checks 
*** RIVER *** [8s 5d 9c Kh] [2h]
v4mp1req: checks 
WI7ZZ: checks 
*** SHOW DOWN ***
v4mp1req: shows [As 5h] (a pair of Fives)
WI7ZZ: mucks hand 
v4mp1req collected $0.19 from pot
*** SUMMARY ***
Total pot $0.20 | Rake $0.01 
Board [8s 5d 9c Kh 2h]
Seat 1: Campbeller (button) folded before Flop (didn't bet)
Seat 2: v4mp1req (small blind) showed [As 5h] and won ($0.19) with a pair of Fives
Seat 3: WI7ZZ (big blind) mucked [6c Qh]
Seat 4: ralf113 folded before Flop (didn't bet)
Seat 5: naueru folded before Flop (didn't bet)
Seat 6: OopSsat folded before Flop (didn't bet)



PokerStars Zoom Hand #188770193327:  Hold'em No Limit ($0.05/$0.10) - 2018/07/15 23:21:18 WET [2018/07/15 18:21:18 ET]
Table 'Aludra' 6-max Seat #1 is the button
Seat 1: DoubleBlue39 ($8.81 in chips) 
Seat 2: FacE_DowN_42 ($68.95 in chips) 
Seat 3: romik313 ($9.71 in chips) 
Seat 4: dzacharas ($10.98 in chips) 
Seat 5: Pinkisu ($8.60 in chips) 
Seat 6: WI7ZZ ($11.05 in chips) 
FacE_DowN_42: posts small blind $0.05
romik313: posts big blind $0.10
*** HOLE CARDS ***
Dealt to WI7ZZ [2s Kh]
dzacharas: folds 
Pinkisu: folds 
WI7ZZ: folds 
DoubleBlue39: folds 
FacE_DowN_42: folds 
Uncalled bet ($0.05) returned to romik313
romik313 collected $0.10 from pot
romik313: doesn't show hand 
*** SUMMARY ***
Total pot $0.10 | Rake $0 
Seat 1: DoubleBlue39 (button) folded before Flop (didn't bet)
Seat 2: FacE_DowN_42 (small blind) folded before Flop
Seat 3: romik313 (big blind) collected ($0.10)
Seat 4: dzacharas folded before Flop (didn't bet)
Seat 5: Pinkisu folded before Flop (didn't bet)
Seat 6: WI7ZZ folded before Flop (didn't bet)



PokerStars Zoom Hand #188770195308:  Hold'em No Limit ($0.05/$0.10) - 2018/07/15 23:21:21 WET [2018/07/15 18:21:21 ET]
Table 'Aludra' 6-max Seat #1 is the button
Seat 1: GSGFM ($15.57 in chips) 
Seat 2: WI7ZZ ($11.05 in chips) 
Seat 3: seba ariza ($35.27 in chips) 
Seat 4: teoter ($12.22 in chips) 
Seat 5: Gelammelt ($8.36 in chips) 
Seat 6: redsy22 ($19.86 in chips) 
WI7ZZ: posts small blind $0.05
seba ariza: posts big blind $0.10
*** HOLE CARDS ***
Dealt to WI7ZZ [Ac 6s]
teoter: folds 
Gelammelt: raises $0.30 to $0.40
redsy22: folds 
GSGFM: folds 
WI7ZZ: folds 
seba ariza: folds 
Uncalled bet ($0.30) returned to Gelammelt
Gelammelt collected $0.25 from pot
Gelammelt: doesn't show hand 
*** SUMMARY ***
Total pot $0.25 | Rake $0 
Seat 1: GSGFM (button) folded before Flop (didn't bet)
Seat 2: WI7ZZ (small blind) folded before Flop
Seat 3: seba ariza (big blind) folded before Flop
Seat 4: teoter folded before Flop (didn't bet)
Seat 5: Gelammelt collected ($0.25)
Seat 6: redsy22 folded before Flop (didn't bet)



PokerStars Zoom Hand #188774817650:  Hold'em No Limit ($0.05/$0.10) - 2018/07/16 2:04:10 WET [2018/07/15 21:04:10 ET]
Table 'Aludra' 6-max Seat #1 is the button
Seat 1: SuDDen1991 ($55.90 in chips) 
Seat 2: willemrules ($11.48 in chips) 
Seat 3: WI7ZZ ($10 in chips) 
Seat 4: HomSet ($10 in chips) 
Seat 5: Gabriel Bast ($10.94 in chips) 
Seat 6: hoffm@n29 ($38.42 in chips) 
willemrules: posts small blind $0.05
WI7ZZ: posts big blind $0.10
*** HOLE CARDS ***
Dealt to WI7ZZ [Ac Ks]
HomSet: folds 
Gabriel Bast: folds 
hoffm@n29: folds 
SuDDen1991: folds 
willemrules: raises $0.15 to $0.25
WI7ZZ: raises $0.55 to $0.80
willemrules: folds 
Uncalled bet ($0.55) returned to WI7ZZ
WI7ZZ collected $0.50 from pot
WI7ZZ: doesn't show hand 
*** SUMMARY ***
Total pot $0.50 | Rake $0 
Seat 1: SuDDen1991 (button) folded before Flop (didn't bet)
Seat 2: willemrules (small blind) folded before Flop
Seat 3: WI7ZZ (big blind) collected ($0.50)
Seat 4: HomSet folded before Flop (didn't bet)
Seat 5: Gabriel Bast folded before Flop (didn't bet)
Seat 6: hoffm@n29 folded before Flop (didn't bet)



